border_size=1
usage=map

Xos         , Xos         , Xos         , Xos         , Xos         , Xos         , Xos         , Xos         , Xos         , Xos         , Xos         , Xos         , Xos         , Xos         , Xos         , Xos         , Xos         , Xos         , Xos         , Xos         , Xos         , Xos         , Xos         , Xos         , Xos         , Rr          , Rrc         , Rr          , Xos         , Xos         , Xos         , Xos         , Xos         , Xos         , Xos         , Xos         , Xos         , Xos         , Xos         , Xos         , Xos         , Xos         , Xos         , Xos         , Xos         , Xos         
Xos         , Xos         , Xos         , Xos         , Xos         , Xos         , Xos         , Xos         , Xos         , Xos         , Xos         , Xos         , Xos         , Xos         , Xos         , Xos         , Xos         , Xos         , Xos         , Xos         , Xos         , Xos         , Xos         , Xos         , Xos         , Rr          , Rrc         , Rr          , Xos         , Xos         , Xos         , Xos         , Xos         , Xos         , Xu          , Xu          , Xu          , Xos         , Xu          , Xos         , Xos         , Xos         , Xos         , Xos         , Xos         , Xos         
Xos         , Xos         , Xos         , Xos         , Xos         , Xos         , Xos         , Xos         , Xos         , Xos         , Xos         , Xos         , Xos         , Xos         , Xos         , Xos         , Xos         , Xos         , Xos         , Xos         , Xos         , Xos         , Xos         , Xos         , Xos         , Rr          , Rrc         , Rr          , Xos         , Xos         , Xos         , Xos         , Xos         , Xu          , Mm          , Mm          , Mm          , Xu          , Mm          , Xu          , Xu          , Xos         , Xos         , Xos         , Xos         , Xos         
Xos         , Xos         , Xos         , Xos         , Xu          , Xu          , Xu          , Xu          , Xu          , Xos         , Xu          , Xu          , Xu          , Xu          , Xu          , Xos         , Xu          , Xos         , Xos         , Xos         , Xos         , Xos         , Xos         , Xos         , Xos         , Rr          , Rrc         , Rr          , Xos         , Xos         , Xos         , Xos         , Xu          , Xu          , Mm          , Mm^Vhh      , Hhd^Srg     , Hh          , Hh          , Mm          , Hh          , Xu          , Xos         , Xos         , Xos         , Xos         
Xos         , Xos         , Xu          , Xu          , Qlfz        , Qlfz        , Hd          , Hd          , Hd          , Xu          , Xu          , Xu          , Qlfz        , Hd          , Hd          , Xu          , Hd          , Xu          , Xu          , Xos         , Xos         , Xos         , Xos         , Xos         , Xos         , Rr          , Rrc         , Rr          , Xos         , Xos         , Xos         , Xos         , Xu          , Hh          , Hh          , Hhd^Srs     , 4 Hhd^Sc    , Hhd^Srj     , Hh          , Mm          , Mm^Vhh      , Xu          , Xos         , Xos         , Xos         , Xos         
Xos         , Xos         , Xu          , Hd^Vda      , Hd          , Hd          , Dd^Srot     , Hd          , Hd          , Hd^Vda      , Hd          , Qlfz        , Hd          , Hd          , Qlfz        , Hd          , Hd          , Qlfz        , Qlfz        , Xu          , Xu          , Xos         , Xos         , Xos         , Xos         , Rr          , Rrc         , Rr          , Xos         , Xos         , Xos         , Xos         , Xu          , Mm          , Mm^Vhh      , Hhd^Sro     , Hhd^Srjs    , Hhd^Sra     , Hh          , Mm          , Xu          , Xu          , Xos         , Xos         , Xos         , Xos         
Xos         , Xos         , Xu          , Qlfz        , Hd          , Qlfz        , 5 Dd^Sct    , Dd^Srst     , Hd          , Hd          , Qlfz        , Hd          , Xu          , Xu          , Xu          , Qlfz        , Xu          , Hd          , Hd          , Xu          , Xu          , Xos         , Xos         , Xos         , Xos         , Rr          , Xu          , Rr          , Xos         , Xos         , Xos         , Xos         , Xu          , Mm          , Mm          , Hh          , Hh          , Hh          , Mm          , Mm          , Xu          , Xos         , Xos         , Xos         , Xos         , Xos         
Xos         , Xos         , Xu          , Qlfz        , Hd          , Dd^Srjl     , Dd^Srgt     , Dd^Srat     , Hd          , Qlfz        , Xu          , Xu          , Xos         , Xos         , Xos         , Xu          , Xu          , Xu          , Qlfz        , Hd          , Xu          , Xos         , Xos         , Xos         , Xos         , Xu          , Xu          , Xu          , Xos         , Xos         , Xos         , Xos         , Xos         , Xu          , Xu          , Hh          , Hh          , Hh          , Xu          , Xu          , Xos         , Xos         , Xos         , Xos         , Xos         , Xos         
Xos         , Xos         , Xu          , Hd          , Hd          , Ch          , Hd          , Hd          , Hd          , Qlfz        , Xu          , Xos         , Xos         , Xos         , Xos         , Xos         , Xos         , Xu          , Qlfz        , Hd          , Hd          , Xu          , Xu          , Xos         , Xos         , Xu          , Rr          , Xu          , Xos         , Xos         , Xos         , Xos         , Xos         , Xos         , Xu          , Hh          , Mm          , Xu          , Xos         , Xos         , Xos         , Xos         , Xos         , Xos         , Xos         , Xos         
Xos         , Xos         , Xu          , Qlfz        , Qlfz        , Hd          , Hd^Vda      , Qlfz        , Qlfz        , Xu          , Xos         , Xos         , Xos         , Xos         , Xos         , Xos         , Xos         , Xu          , Xu          , Qlfz        , Hd          , Hd          , Xu          , Xos         , Xos         , Rr          , Rr          , Rr          , Xos         , Xos         , Xos         , Xos         , Xos         , Xos         , Xu          , Mm          , Hh          , Xu          , Xos         , Xos         , Xos         , Xos         , Xos         , Xos         , Xos         , Xos         
Xos         , Xos         , Xos         , Xu          , Xu          , Hd          , Xu          , Qlfz        , Xu          , Xu          , Xos         , Xos         , Xos         , Xos         , Xos         , Xos         , Xos         , Xos         , Xos         , Xu          , Hd          , Qlfz        , Xu          , Xos         , Xos         , Rr          , Rr          , Rr          , Xos         , Xos         , Xos         , Xos         , Xos         , Xos         , Xos         , Xu          , Hh          , Xu          , Xu          , Xos         , Xos         , Xos         , Xos         , Xos         , Xos         , Xos         
Xos         , Xos         , Xos         , Xos         , Xos         , Xu          , Xu          , Xu          , Xu          , Xos         , Xos         , Xos         , Xos         , Xos         , Xos         , Xos         , Xos         , Xos         , Xol         , Xu          , Rr          , Qlfz        , Xu          , Xol         , Xol         , Rr          , Rr          , Rr          , Xos         , Xos         , Xos         , Xos         , Xos         , Xos         , Xos         , Xu          , Hh          , Hh          , Xu          , Xos         , Xos         , Xos         , Xos         , Xos         , Xos         , Xos         
Xos         , Xos         , Xos         , Xos         , Xos         , Xu          , Qxu         , Qxu         , Qxu         , Xu          , Xu          , Xu          , Xu          , Xos         , Xos         , Xos         , Xol         , Xol         , Rr          , Rr          , Rr          , Rr          , Rr          , Rr          , Rr          , Rr          , Rr          , Rr          , Xos         , Xos         , Xos         , Xos         , Xos         , Xos         , Xu          , Xu          , Hh          , Mm          , Xu          , Xos         , Xos         , Xos         , Xos         , Xos         , Xos         , Xos         
Xos         , Xos         , Xos         , Xos         , Xu          , Xu          , Ur          , Ur          , Ur          , Ur          , Ur          , Qxu         , Qxu         , Xu          , Xos         , Xos         , Xu          , Rr          , Rr          , Rr          , Rr^Vct      , Rr          , Rr          , Rr          , Rr          , Rr          , Rr          , Rr          , Xos         , Xos         , Xos         , Xos         , Xu          , Xu          , Mm          , Hh          , Mm          , Mm          , Xu          , Xos         , Xos         , Xos         , Xos         , Xos         , Xos         , Xos         
Xos         , Xos         , Xu          , Xu          , Qxu         , Qxu         , Ur          , Xu          , Xu          , Qxu         , Qxu         , Ur          , Qxu         , Xu          , Xu          , Xu          , Qxu         , Rr          , Rr          , Rr          , Ce          , Ce          , Ce          , Rr          , Rr          , Rr          , Rr          , Rr          , Xos         , Xos         , Xu          , Xu          , Xu          , Mm          , Hh          , Hh          , Xu          , Xu          , Xos         , Xos         , Xos         , Xos         , Xos         , Xos         , Xos         , Xos         
Xos         , Xos         , Xu          , Qxu         , Ur          , Ur          , Qxu         , Xu          , Xos         , Xu          , Qxu         , Ur          , Ur          , Xu          , Xu          , Qxu         , Ur          , Rr          , Rr          , Rr          , Ce          , 2 Ke        , Ce          , Rr^Vct      , Rr^Ii       , Rr          , Rr^Vct      , Rr          , Rr          , Xu          , Mm          , Hh          , Hh          , Mm          , Xu          , Xu          , Xos         , Xos         , Xos         , Xos         , Xos         , Xos         , Xos         , Xos         , Xos         , Xos         
Xos         , Xos         , Xu          , Ur          , Ur          , Qxu         , Xu          , Xu          , Xos         , Xu          , Xu          , Ur          , Qxu         , Ur          , Ur          , Ur          , Ur          , Rr          , Rr          , Rr          , Rr          , Ce          , Rr^Ii       , Rr^Ii       , Ce          , Ce          , Ce          , Rr          , Rr          , Rr          , Mm          , Hh          , Xu          , Xu          , Xos         , Xos         , Xos         , Xos         , Xos         , Xos         , Xos         , Xos         , Xos         , Xos         , Xos         , Xos         
Xos         , Xu          , Xu          , Qxu         , Ur          , Qxu         , Xu          , Xos         , Xos         , Xos         , Xos         , Xu          , Xu          , Qxu         , Xu          , Qxu         , Qxu         , Qxu         , Rr          , Rr          , Rr          , Rr^Vct      , Rr          , Rr^Ii       , Ce          , 1 Ke        , Ce          , Rr          , Rr          , Rr          , Xu          , Xu          , Xos         , Xos         , Xos         , Xos         , Xos         , Xos         , Xu          , Xos         , Xos         , Xos         , Xos         , Xos         , Xos         , Xos         
Xos         , Xu          , Wwf         , Qxu         , Ur          , Xu          , Xol         , Xol         , Cud         , Xol         , Xol         , Xos         , Xos         , Xu          , Xos         , Xu          , Rr          , Rr          , Rr          , Rr          , Rr          , Rr          , Rr          , Rr^Vct      , Rr          , Ce          , Rr          , Rr^Vct      , Rr          , Rr          , Xos         , Xos         , Xos         , Xos         , Xos         , Xos         , Xu          , Xu          , Ww          , Xu          , Xu          , Xos         , Xos         , Xos         , Xos         , Xos         
Xos         , Xu          , Qxu         , Qxu         , Ur          , Xu          , Xol         , Cud         , Iwr         , Cud         , Cud         , Xos         , Xos         , Xos         , Rr          , Rr          , Rr          , Rr          , Xos         , Xos         , Rr          , Rr          , Rr          , Rr          , Rr          , Rr          , Rr          , Rr          , Xos         , Xos         , Xos         , Xos         , Xos         , Xos         , Xu          , Xu          , Wwf         , Ww          , Wwf         , Ww          , Wwf         , Xu          , Xu          , Xos         , Xos         , Xos         
Xos         , Xu          , Ur          , Ur          , Xos         , Xol         , Iwr         , Iwr         , Iwr         , Iwr         , Iwr         , Xos         , Xu          , Xu          , Xu          , Rr          , Xos         , Xos         , Cud         , Xos         , Xos         , Rr          , Rr          , Rr          , Xu          , Rr          , Xu          , Xos         , Xos         , Xos         , Xos         , Xos         , Xos         , Xu          , Ww^Vm       , Ww          , Wwf^Sra     , Ww          , Wwf^Srs     , Ww          , Ww^Vm       , Wwf         , Xu          , Xos         , Xos         , Xos         
Xos         , Xu          , Ur          , Qxu         , Xos         , Cud         , Iwr         , Iwr         , Kh^Ii       , Iwr         , Iwr         , Iwr         , Iwr         , Xu          , Xos         , Xos         , Iwr         , Iwr         , Iwr         , Cud         , Xos         , Rr          , Wwf         , Xu          , Wwf         , Xu          , Ww          , Xu          , Xu          , Xu          , Xu          , Xos         , Xu          , Xu          , Wwf         , Ww          , Ww          , 6 Wwf^Sc    , Wwf^Srg     , Ww          , Ww          , Wwf         , Xu          , Xos         , Xos         , Xos         
Xos         , Xu          , Ur          , Qxu         , Xos         , Cud         , Iwr         , Iwr         , Iwr         , Iwr         , Iwr         , Iwr         , Iwr         , Xos         , Iwr         , Cud         , Iwr         , Cud         , Xos         , Xos         , Xos         , Xu          , Wwf         , Wwf         , Ww          , Wwf         , Wwf         , Wwf         , Wwf         , Ww          , Ww          , Xu          , Wwf         , Wwf         , Ww          , Wwf         , Wwf         , Wwf^Sro     , Ww          , Wwf         , Ww          , Xu          , Xos         , Xos         , Xos         , Xos         
Xos         , Xu          , Qxu         , Ur          , Xos         , Iwr         , Iwr         , Iwr         , Cud         , Cud         , Iwr         , Iwr         , Iwr         , Iwr         , Uu^Ii       , Iwr         , Xos         , Xos         , Xol         , Xos         , Xos         , Xu          , Xu          , Ww          , Xu          , Ww          , Xu          , Xu          , Xu          , Wwf         , Wwf         , Ww          , Wwf         , Ww          , Xu          , Ww          , Wwf         , Ww          , Xu          , Ww^Vm       , Xu          , Xu          , Xos         , Xos         , Xos         , Xos         
Xos         , Xu          , Qxu         , Ur          , Xol         , Cud         , Cud         , Iwr         , Iwr         , Iwr         , Cud         , Cud         , Iwr         , Iwr         , Iwr         , Iwr         , Iwr         , Cud         , Cud         , Xol         , Xol         , Xos         , Xos         , Xu          , Xu          , Xu          , Qxu         , Xu          , Xu          , Xu          , Xu          , Wwf         , Xu          , Xu          , Xos         , Xu          , Xu          , Xu          , Xos         , Xu          , Xos         , Xos         , Xos         , Xos         , Xos         , Xos         
Xos         , Xu          , Qxu         , Ur          , Ur          , Xol         , Xos         , Cud         , Iwr         , Iwr         , Iwr         , Iwr         , Cud         , Cud         , Iwr         , Iwr         , Iwr         , Iwr         , Iwr         , Cud         , Cud         , Xol         , Xol         , Xu          , Qxu         , Qxu         , Ur          , Qxu         , Qxu         , Xu          , Xu          , Xu          , Xos         , Xos         , Xos         , Xos         , Xos         , Xos         , Xos         , Xos         , Xos         , Xos         , Xos         , Xos         , Xos         , Xos         
Xos         , Xu          , Xu          , Ur          , Ur          , Xu          , Xu          , Xos         , Xos         , Iwr         , Iwr         , Iwr         , Iwr         , Iwr         , Iwr         , Urb^Ii      , Iwr         , Iwr         , Iwr         , Iwr         , Iwr         , Cud         , Xos         , Xu          , Qxu         , Ur^Vu       , Qxu         , Ur          , Ur          , Qxu         , Qxu         , Xu          , Xu          , Xos         , Xos         , Xos         , Xos         , Xos         , Xos         , Xos         , Xos         , Xos         , Xos         , Xos         , Xos         , Xos         
Xos         , Xos         , Xu          , Ur          , Ur          , Qxu         , Qxu         , Xu          , Xos         , Cud         , Cud         , Iwr         , Iwr         , Iwr         , Iwr         , Iwr         , Cud         , Cud         , Iwr         , Iwr         , Iwr^Srgt    , Xos         , Qxu         , Qxu         , Qxu         , Qxu         , Urb^Srst    , Chr         , Ur          , Qxu         , Ur^Vu       , Qxu         , Xu          , Xos         , Xos         , Xos         , Xos         , Xos         , Xos         , Xos         , Xos         , Xos         , Xos         , Xos         , Xos         , Xos         
Xos         , Xos         , Xos         , Xu          , Xu          , Ur          , Ur          , Qxu         , Xu          , Xos         , Xos         , Cud         , Cud         , Iwr         , Iwr         , Iwr         , Iwr         , Iwr         , Iwr^Srgt    , 7 Kud       , Cud         , Xos         , Qxu         , Ur^Vu       , Qxu         , Urb^Srat    , 3 Urb^Sct   , Ur          , Chr         , Qxu         , Ur          , Qxu         , Xu          , Xos         , Xos         , Xos         , Xos         , Xos         , Xos         , Xos         , Xos         , Xos         , Xos         , Xos         , Xos         , Xos         
Xos         , Xos         , Xos         , Xos         , Xos         , Xu          , Ur          , Ur          , Ur          , Xu          , Xu          , Xol         , Xol         , Cud         , Cud         , Iwr         , Xol         , Xos         , Xol         , Cud         , Xol         , Xos         , Qxu         , Ur          , Qxu         , Urb^Srot    , Urb^Srjt    , Urb^Srat    , Qxu         , Ur          , Qxu         , Qxu         , Xu          , Xos         , Xos         , Xos         , Xos         , Xos         , Xos         , Xos         , Xos         , Xos         , Xos         , Xos         , Xos         , Xos         
Xos         , Xos         , Xos         , Xos         , Xos         , Xu          , Xu          , Qxu         , Qxu         , Ur          , Ur          , Qxu         , Qxu         , Xol         , Xol         , Xol         , Qxu         , Qxu         , Qxu         , Xol         , Ur          , Xu          , Ur          , Ur          , Ur          , Ur          , Ur          , Ur          , Qxu         , Qxu         , Xu          , Xu          , Xos         , Xos         , Xos         , Xos         , Xos         , Xos         , Xos         , Xos         , Xos         , Xos         , Xos         , Xos         , Xos         , Xos         
Xos         , Xos         , Xos         , Xos         , Xos         , Xos         , Xos         , Xu          , Xu          , Qxu         , Xu          , Ur          , Ur          , Ur          , Ur          , Ur          , Ur          , Ur          , Ur          , Ur          , Qxu         , Ur          , Qxu         , Ur          , Qxu         , Qxu         , Qxu         , Qxu         , Xu          , Xu          , Xos         , Xos         , Xos         , Xos         , Xos         , Xos         , Xos         , Xos         , Xos         , Xos         , Xos         , Xos         , Xos         , Xos         , Xos         , Xos         
Xos         , Xos         , Xos         , Xos         , Xos         , Xos         , Xos         , Xos         , Xos         , Xu          , Xos         , Xu          , Xu          , Qxu         , Qxu         , Qxu         , Xu          , Xu          , Xu          , Xu          , Xu          , Qxu         , Xu          , Qxu         , Xu          , Xu          , Xu          , Xu          , Xos         , Xos         , Xos         , Xos         , Xos         , Xos         , Xos         , Xos         , Xos         , Xos         , Xos         , Xos         , Xos         , Xos         , Xos         , Xos         , Xos         , Xos         
Xos         , Xos         , Xos         , Xos         , Xos         , Xos         , Xos         , Xos         , Xos         , Xos         , Xos         , Xos         , Xos         , Xu          , Xu          , Xu          , Xos         , Xos         , Xos         , Xos         , Xos         , Xu          , Xos         , Xu          , Xos         , Xos         , Xos         , Xos         , Xos         , Xos         , Xos         , Xos         , Xos         , Xos         , Xos         , Xos         , Xos         , Xos         , Xos         , Xos         , Xos         , Xos         , Xos         , Xos         , Xos         , Xos         
Xos         , Xos         , Xos         , Xos         , Xos         , Xos         , Xos         , Xos         , Xos         , Xos         , Xos         , Xos         , Xos         , Xos         , Xos         , Xos         , Xos         , Xos         , Xos         , Xos         , Xos         , Xos         , Xos         , Xos         , Xos         , Xos         , Xos         , Xos         , Xos         , Xos         , Xos         , Xos         , Xos         , Xos         , Xos         , Xos         , Xos         , Xos         , Xos         , Xos         , Xos         , Xos         , Xos         , Xos         , Xos         , Xos         
