border_size=1
usage=map

Xos         , Xos         , Xos         , Xos         , Xos         , Xos         , Xos         , Xos         , Xos         , Xos         , Iwr         , Iwr         , Iwr         , Xos         , Xos         , Xos         , Xos         , Xos         , Xos         , Xos         , Xos         , Xos         , Xos         
Xos         , Xos         , Xos         , Xos         , Xos         , Xos         , Xos         , Xos         , Xos         , Xos         , Iwr         , Iwr         , Iwr         , Xos         , Xos         , Xos         , Xos         , Xos         , Xos         , Xos         , Xos         , Xos         , Xos         
Xos         , Xos         , Xos         , Xos         , Xos         , Xos         , Xos         , Xos         , Xos         , Xos         , Iwr         , Iwr         , Iwr         , Xos         , Xos         , Xos         , Xos         , Xos         , Xos         , Xos         , Xos         , Xos         , Xos         
Xos         , Xos         , Xos         , Xos         , Xos         , Xos         , Xos         , Xos         , Mm^Xm       , Mm^Xm       , Cv          , Iwr         , Cv          , Mm^Xm       , Mm^Xm       , Xos         , Xos         , Xos         , Xos         , Xos         , Xos         , Xos         , Xos         
Xos         , Xos         , Xos         , Xos         , Xos         , Xos         , Xos         , Xos         , Mm          , Cv          , Cv          , 3 Kv        , Cv          , Cv          , Mm          , Xos         , Xos         , Xos         , Xos         , Xos         , Xos         , Xos         , Xos         
Xos         , Xos         , Xos         , Xos         , Mm^Xm       , Mm^Xm       , Mm          , Mm          , Mm          , Cv          , Mm          , Cv          , Mm          , Cv          , Mm          , Mm          , Mm          , Mm^Xm       , Mm^Xm       , Xos         , Xos         , Xos         , Xos         
Xos         , Xos         , Xos         , Mm^Xm       , Cv          , Cv          , Mm          , Hh          , Mm          , Mm          , Mm          , Mm          , Mm          , Mm          , Mm          , Hh          , Mm          , Cv          , Cv          , Mm^Xm       , Xos         , Xos         , Xos         
Xos         , Xos         , Mm          , Mm          , Hh          , Mm          , Mm          , Mm          , Hh          , Mm          , Cv          , Cv          , Cv          , Mm          , Hh          , Mm          , Mm          , Mm          , Hh          , Mm          , Mm          , Xos         , Xos         
Xos         , Mm^Xm       , Mm          , Mm          , Mm          , Hh          , Mm          , Hh          , Mm          , Mm          , Hh          , Cv          , Hh          , Mm          , Mm          , Hh          , Mm          , Hh          , Mm          , Mm          , Mm          , Mm^Xm       , Xos         
Xos         , Mm^Xm       , Mm          , Cv          , Cv          , Mm          , Mm          , Cv          , Mm          , Hh          , Mm          , Mm          , Mm          , Hh          , Mm          , Cv          , Mm          , Mm          , Cv          , Cv          , Mm          , Mm^Xm       , Xos         
Xos         , Mm^Xm       , Mm          , Mm          , Cv          , Hh          , Mm          , Cv          , Mm          , Mm          , Cv          , Hh          , Cv          , Mm          , Mm          , Cv          , Mm          , Hh          , Cv          , Mm          , Mm          , Mm^Xm       , Xos         
Xos         , Xos         , Mm          , Hh          , Mm          , Mm          , Hh          , Hh          , Mm          , Mm          , Cv          , Hh          , Cv          , Mm          , Mm          , Hh          , Hh          , Mm          , Mm          , Hh          , Mm          , Xos         , Xos         
Xos         , Xos         , Mm          , Hh          , Mm          , Mm          , Mm          , Mm          , Mm          , Cv          , Hh          , Hh          , Hh          , Cv          , Mm          , Mm          , Mm          , Mm          , Mm          , Hh          , Mm          , Xos         , Xos         
Xos         , Mm^Xm       , Mm          , Mm          , Cv          , Cv          , Cv          , Hh          , Mm          , Mm          , Rr          , Hh          , Rr          , Mm          , Mm          , Hh          , Cv          , Cv          , Cv          , Mm          , Mm          , Mm^Xm       , Xos         
Xos         , Mm^Xm       , Mm          , Hh          , Hh          , Mm          , Mm          , Mm          , Rr          , Rr          , Rr          , Rr          , Rr          , Rr          , Rr          , Mm          , Mm          , Mm          , Hh          , Hh          , Mm          , Mm^Xm       , Xos         
Xos         , Mm^Xm       , Mm^Xm       , Mm          , Mm          , Mm          , Rr          , Rr          , Ch          , Ch          , Rr          , Rr          , Rr          , Ch          , Ch          , Rr          , Rr          , Mm          , Mm          , Mm          , Mm^Xm       , Mm^Xm       , Xos         
Xol         , Xos         , Xos         , Mm^Xm       , Mm^Xm       , Rr          , Rr          , Rr          , Ch          , Kh          , Rr          , Rr          , Rr          , Kh          , Ch          , Rr          , Rr          , Rr          , Mm^Xm       , Mm^Xm       , Xos         , Xos         , Xol         
Xol         , Xol         , Xol         , Xos         , Xos         , Xos         , Xos         , Rr          , Rr          , Ch          , Rrc         , Rr          , Rrc         , Ch          , Rr          , Rr          , Xos         , Xos         , Xos         , Xos         , Xol         , Xol         , Xol         
Xol         , Xol         , Xol         , Xol         , Xol         , Xos         , Xos         , Xos         , Xos         , Rr          , Rr          , Rrc         , Rr          , Rr          , Xos         , Xos         , Xos         , Xos         , Xol         , Xol         , Xol         , Xol         , Xol         
Xol         , Xol         , Xol         , Xol         , Xol         , Xol         , Xol         , Xos         , Xos         , Xos         , 1 Rr        , Rrc         , 2 Rr        , Xos         , Xos         , Xos         , Xol         , Xol         , Xol         , Xol         , Xol         , Xol         , Xol         
Xol         , Xol         , Xol         , Xol         , Xol         , Xol         , Xol         , Xol         , Xos         , Xos         , Rr          , Rrc         , Rr          , Xos         , Xos         , Xol         , Xol         , Xol         , Xol         , Xol         , Xol         , Xol         , Xol         
Xol         , Xol         , Xol         , Xol         , Xol         , Xol         , Xol         , Xol         , Xos         , Xos         , Rr          , Rrc         , Rr          , Xos         , Xos         , Xol         , Xol         , Xol         , Xol         , Xol         , Xol         , Xol         , Xol         
