border_size=1
usage=map

Gg          , Gg          , Gg          , Gg          , Gg          , Gg          , Gg          , Gll^Fp      , Gg          , Gg          , Gll^Fp      , Gg          , Gg          , Gg          , Gg          , Aa^Fpa      , Aa^Fpa      , Gg          , Gll^Fp      , Gll^Fp      , Aa^Fpa      , Gg          , Gg          , Gg          , Ha          , Gg          , Hh          , Gg          , Aa          , Gg          , Hh          , Ms          , Ms          , Ms^Xm       , Ms^Xm       , Ms          , Ms          , Ms^Xm       , Mm          , Mm          , Ms          , Mm^Xm       , Mm^Xm       , Ms          , Mm          , Mm          
Gg          , Gg          , Gg          , Gg          , Gll^Fp      , Gg          , Aa          , Gll^Fp      , Aa          , Gg          , Gll^Fp      , Gll^Fp      , Gg          , Gg          , Gll^Fp      , Gll^Fp      , Gg          , Gg          , Gg          , Gll^Fp      , Gg          , Gg          , Gg          , Ha          , Gg          , Gg          , Hh          , Aa          , Aa          , Gg          , Hh          , Mm          , Ms          , Ms          , Mm          , Ms^Xm       , Ms^Xm       , Ms          , Ha          , Ha          , Ha          , Ms          , Ms          , Ms          , Mm^Xm       , Mm          
Gg          , Gg          , Gg          , Gg          , Gg          , Gll^Fp      , Aa          , Aa          , Gg          , Aa          , Gg          , Gg          , Gg          , Aa^Fpa      , Gg          , Gg          , Gll^Fp      , Gg          , Gg          , Gg          , Gg          , Gg          , Gg          , Hh          , Gg          , Gg          , Gg          , Hh          , Aa          , Aa          , Gg          , Ms          , Ms          , Mm          , Ha          , Mm          , Ms          , Ms^Xm       , Ms^Xm       , Mm          , Mm          , Ms          , Ms          , Ms          , Mm          , Mm          
Gg          , Gg          , Gg          , Gg          , Gg          , Aa          , Aa          , Gg          , Gg          , Gg          , Gg          , Gg          , Gg          , Gg          , Gg          , Gll^Fp      , Gg          , Aa          , Aa          , Gg          , Gg          , Gll^Fp      , Aa^Fpa      , Gg          , Hh          , Hh          , Hh          , Gg          , Gg          , Gg          , Gg          , Hh          , Hh          , Ms          , Ms          , Ha          , Ms          , Ms          , Mm          , Mm          , Ms^Xm       , Ms          , Ms          , Ms          , Mm          , Mm          
Gg          , Gg          , Gll^Fp      , Gg          , Gll^Fp      , Gg          , Gg          , Gll^Fp      , Aa^Fpa      , Aa^Fpa      , Gg          , Aa^Fpa      , Aa^Fpa      , Gg          , Gg          , Gg          , Gll^Fp      , Gll^Fp      , Gll^Fp      , Aa          , Gg          , Gll^Fp      , Aa^Fpa      , Aa          , Gg          , Gg          , Aa          , Gg          , Hh          , Gg          , Rr^Vhc      , Gg          , Cvj         , Gg          , Hh          , Mm          , Hh          , Ha          , Ha          , Mm          , Mm          , Mm          , Ha          , Mm          , Ha          , Mm          
Gg          , Gg          , Gll^Fp      , Gll^Fp      , Gll^Fp      , Gg          , Gg          , Gll^Fp      , Gll^Fp      , Gg          , Gg          , Gll^Fp      , Gg          , Gg          , Gll^Fp      , Gg          , Gll^Fp      , Gll^Fp      , Gg          , Gg          , Aa          , Aa          , Aa          , Aa          , Gg          , Ha          , Aa          , Aa          , Hh          , Gg          , Gg          , Gg          , Gg          , Gg          , Cvj         , Hh          , Gg          , Cvj         , Cvj         , Hh          , Hh          , Hh          , Cvj         , Ha          , Hh          , Mm          
Gg          , Gg          , Gg          , Gll^Fp      , Gll^Fp      , Gg          , Gg          , Gg          , Gg          , Aa          , Aa          , Aa          , Aa          , Gll^Fp      , Gll^Fp      , Gg          , Gg          , Gg          , Aa^Fpa      , Gg          , Gll^Fp      , Gg          , Gg          , Hh          , Gg          , Ha          , Gg          , Hh          , Gg          , Gg          , Cvj         , Cvj         , Gg          , Cvj         , Gg          , Cvj         , Gg          , Cvj         , Gg          , Gg          , Rrc         , Cvj         , Cvj         , Hh          , Cvj         , Hh          
Gg          , Gg          , Gg          , Gg          , Gg          , Gg          , Gg          , Gg          , Gg          , Gg          , Gg          , Gg          , Aa          , Aa          , Gg          , Gg          , Gll^Fp      , Aa^Fpa      , Aa^Fpa      , Gg          , Gg          , Gll^Fp      , Gg          , Ha          , Ha          , Gg          , Hh          , Gg          , Hh          , Gg          , Gg          , Cvj         , Gg          , Gg          , Rrc         , Rrc         , Rrc         , Gg          , Rrc         , Rrc         , Cvj         , Rrc         , Rrc         , Gg          , Cvj         , Cvj         
Gll^Fp      , Gll^Fp      , Gll^Fp      , Gg          , Gg          , Re^Vct      , Gg          , Gg          , Aa^Fpa      , Gll^Fp      , Aa^Fpa      , Gll^Fp      , Gg          , Aa          , Gg          , Gg          , Gg          , Gll^Fp      , Gll^Fp      , Gg          , Gg          , Aa^Fpa      , Aa^Fpa      , Gg          , Aa          , Aa          , Aa          , Hh          , Gg          , Gg          , Gg          , Gg          , Cvj         , Rrc         , Cvj         , Cvj         , Cvj         , Rrc         , Rrc         , Cvj         , 4 Kvj       , Cvj         , Rrc         , Gg          , Gg          , Gg          
Gll^Fp      , Gll^Fp      , Gll^Fp      , Gg          , Gg          , Gg          , Gg          , Gg          , Gll^Fp      , Aa^Fpa      , Gll^Fp      , Gg          , Gg          , Gll^Fp      , Gll^Fp      , Gg          , Gg          , Gg          , Gg          , Gg          , Gg          , Aa^Fpa      , Gll^Fp      , Gll^Fp      , Gg          , Aa          , Gg          , Gg          , Ha          , Ha          , Hh          , Gg          , Cvj         , Rrc         , Cvj         , 3 Kvj       , Cvj         , Rrc         , Rrc         , Cvj         , Cvj         , Cvj         , Rrc         , Rr^Vhc      , Gg          , Gg          
Gg          , Gg          , Gg          , Gg          , Gg          , Re^Vct      , Gg          , Gg          , Gg          , Aa^Fpa      , Gg          , Gg          , Gg          , Gll^Fp      , Gll^Fp      , Gll^Fp      , Gg          , Gg          , Gg          , Gg          , Gg          , Gg          , Gg          , Gg          , Gll^Fp      , Gll^Fp      , Gll^Fp      , Gg          , Gg          , Gg          , Gg          , Gg          , Gg          , Rrc         , Rrc         , Cvj         , Rrc         , Rrc         , Gg          , Rrc         , Rrc         , Rrc         , Gg          , Gg          , Cvj         , Gg          
Gg          , Gg          , Re^Vct      , Ce          , Ce          , Gg          , Gg          , Gg          , Re^Vct      , Gg          , Gg          , Gg          , Gll^Fp      , Gg          , Gg          , Aa          , Aa          , Gg          , Gll^Fp      , Gll^Fp      , Gll^Fp      , Gg          , Gg          , Gg          , Gg          , Aa^Fpa      , Aa^Fpa      , Gg          , Gg          , Hh          , Hh          , Hh          , Gg          , Cvj         , Cvj         , Rrc         , Gg          , Gg          , Rr^Vhc      , Gg          , Rrc         , Rr^Vhc      , Gg          , Cvj         , Cvj         , Cvj         
Gg          , Gg          , Gg          , Ce          , 2 Ke        , Ce          , Ce          , Gg          , Gg          , Gg          , Gg          , Gll^Fp      , Aa^Fpa      , Gll^Fp      , Gll^Fp      , Aa^Fpa      , Aa^Fpa      , Aa          , Aa          , Gll^Fp      , Gll^Fp      , Gll^Fp      , Gg          , Gg          , Aa^Fpa      , Gg          , Gg          , Gll^Fp      , Aa          , Aa          , Aa          , Gg          , Hh          , Gg          , Gg          , Gg          , Rr^Vhc      , Rrc         , Gg          , Gg          , Rrc         , Gg          , Gg          , Cvj         , Hh          , Hh          
Gll^Fp      , Gg          , Gg          , Ce          , Ce          , Ce          , Gg          , Gg          , Gg          , Gg          , Gg          , Aa^Fpa      , Gll^Fp      , Gll^Fp      , Aa^Fpa      , Aa^Fpa      , Gll^Fp      , Aa          , Gg          , Gg          , Gg          , Gg          , Gg          , Gll^Fp      , Aa^Fpa      , Gll^Fp      , Gg          , Gg          , Gg          , Aa          , Gg          , Hh          , Cvj         , Cvj         , Gg          , Gg          , Rrc         , Rrc         , Rrc         , Rrc         , Rr^Vhc      , Rrc         , Gg          , Hh          , Mm^Xm       , Mm          
Gll^Fp      , Gll^Fp      , Gg          , Ce          , Gg          , Gg          , Re^Vct      , Gg          , Gg          , Gg          , Gg          , Gll^Fp      , Gg          , Gll^Fp      , Gll^Fp      , Gll^Fp      , Gg          , Aa          , Gll^Fp      , Gg          , Gg          , Gg          , Gg          , Gll^Fp      , Gll^Fp      , Gll^Fp      , Gg          , Gll^Fp      , Gg          , Ha          , Gg          , Hh          , Gg          , Hh          , Gg          , Rr^Vhc      , Gg          , Gg          , Rrc         , Cvj         , Cvj         , Cvj         , Hh          , Mm          , Mm          , Mm          
Gll^Fp      , Gll^Fp      , Gg          , Gg          , Gg          , Gg          , Gg          , Gg          , Gg          , Re^Vct      , Gg          , Gg          , Gg          , Gg          , Gg          , Gg          , Aa          , Aa          , Gll^Fp      , Aa^Fpa      , Gll^Fp      , Aa          , Aa          , Aa          , Aa          , Gg          , Aa^Fpa      , Aa^Fpa      , Gll^Fp      , Ha          , Ha          , Gg          , Hh          , Hh          , Cvj         , Gg          , Gg          , Rr^Vhc      , Cvj         , Gg          , Hh          , Hh          , Ms          , Ms          , Mm^Xm       , Mm          
Gll^Fp      , Gll^Fp      , Gg          , Re^Vct      , Ce          , Ce          , Ce          , Gg          , Gg          , Gg          , Aa^Fpa      , Gg          , Gg          , Re^Vct      , Gg          , Gg          , Gg          , Gg          , Gll^Fp      , Aa^Fpa      , Gg          , Gg          , Gg          , Gll^Fp      , Aa          , Gg          , Gg          , Gll^Fp      , Aa          , Gg          , Gg          , Gg          , Gg          , Cvj         , Hh          , Cvj         , Gg          , Cvj         , Hh          , Hh          , Ha          , Hh          , Hh          , Ms          , Ms          , Mm          
Gg          , Gg          , Gg          , Ce          , Ce          , 1 Ke        , Ce          , Gg          , Gg          , Aa^Fpa      , Aa^Fpa      , Gll^Fp      , Gg          , Gg          , Gll^Fp      , Gll^Fp      , Gll^Fp      , Gg          , Gg          , Aa^Fpa      , Gg          , Gg          , Aa^Fpa      , Gll^Fp      , Gll^Fp      , Gll^Fp      , Gg          , Aa          , Aa          , Ha          , Gg          , Hh          , Gg          , Hh          , Gg          , Hh          , Gg          , Hh          , Hh          , Ha          , Ms^Xm       , Mm          , Ha          , Mm          , Ha          , Mm          
Gg          , Gg          , Re^Vct      , Ce          , Ce          , Ce          , Re^Vct      , Gg          , Gg          , Gll^Fp      , Aa^Fpa      , Gll^Fp      , Aa          , Gg          , Gll^Fp      , Aa^Fpa      , Aa^Fpa      , Gg          , Gg          , Gg          , Gll^Fp      , Gg          , Gg          , Aa^Fpa      , Gg          , Gg          , Gll^Fp      , Aa          , Hh          , Ha          , Gg          , Hh          , Hh          , Gg          , Gg          , Gg          , Hh          , Mm          , Mm^Xm       , Ms          , Ms          , Ms^Xm       , Ms^Xm       , Mm          , Mm          , Ha          
Gg          , Gg          , Gg          , Gg          , Gg          , Gg          , Gg          , Gg          , Gg          , Gll^Fp      , Gg          , Gll^Fp      , Gg          , Aa          , Gg          , Aa^Fpa      , Gll^Fp      , Gg          , Gg          , Gll^Fp      , Aa^Fpa      , Gg          , Gg          , Gg          , Gll^Fp      , Gg          , Gg          , Gg          , Gg          , Gg          , Ha          , Gg          , Gg          , Gg          , Hh          , Hh          , Mm          , Mm          , Mm          , Mm          , Ha          , Ms          , Ms          , Ms^Vhha     , Mm          , Mm          
Gll^Fp      , Gg          , Gg          , Gll^Fp      , Gll^Fp      , Aa^Fpa      , Gll^Fp      , Gg          , Gg          , Aa          , Aa          , Gg          , Aa          , Aa          , Gg          , Gll^Fp      , Gll^Fp      , Gll^Fp      , Gg          , Gg          , Gg          , Gg          , Gll^Fp      , Gll^Fp      , Aa^Fpa      , Gll^Fp      , Gg          , Gll^Fp      , Gg          , Ha          , Aa          , Hh          , Gg          , Gg          , Mm          , Mm^Xm       , Mm^Xm       , Mm          , Mm          , Ha          , Mm          , Mm          , Mm          , Mm          , Hh          , Mm          
Gg          , Gll^Fp      , Gg          , Gg          , Gg          , Aa^Fpa      , Gg          , Gg          , Gg          , Gg          , Gll^Fp      , Aa          , Gg          , Aa          , Gg          , Gg          , Gg          , Gg          , Aa          , Gll^Fp      , Gll^Fp      , Gg          , Gg          , Gll^Fp      , Aa^Fpa      , Gll^Fp      , Gg          , Gg          , Ha          , Aa          , Aa          , Gg          , Hh          , Hh          , Ha          , Mm          , Mm          , Mm^Xm       , Mm          , Mm          , Hh          , Mm          , Cud         , Hh          , Cud         , Hh          
Gll^Fp      , Gll^Fp      , Gg          , Gg          , Gg          , Gg          , Gg          , Gg          , Aa^Fpa      , Gg          , Gg          , Gg          , Gg          , Gg          , Aa          , Gg          , Aa          , Gg          , Aa          , Gg          , Gg          , Gg          , Gg          , Gll^Fp      , Gll^Fp      , Gg          , Gg          , Hh          , Aa          , Ha          , Gg          , Hh          , Mm          , Mm^Xm       , Mm          , Mm          , Mm          , Mm          , Mm          , Hh          , Cud         , Hh          , Urb         , Hh          , Hh          , Hh          
Gll^Fp      , Gll^Fp      , Aa          , Aa          , Aa          , Gll^Fp      , Gll^Fp      , Gll^Fp      , Aa^Fpa      , Gll^Fp      , Gg          , Gg          , Gg          , Gll^Fp      , Aa^Fpa      , Aa          , Gg          , Aa          , Gll^Fp      , Aa^Fpa      , Gll^Fp      , Gg          , Gg          , Gg          , Aa^Fpa      , Gll^Fp      , Aa          , Aa          , Ha          , Gg          , Gg          , Ha          , Mm          , Mm          , Ha          , Ha          , Mm          , Mm          , Mm          , Hh          , Urb         , Urb         , Urb         , Urb         , Urb         , Hh          
Gg          , Gll^Fp      , Gg          , Aa          , Aa          , Gg          , Gg          , Gll^Fp      , Gll^Fp      , Aa^Fpa      , Gg          , Gg          , Gll^Fp      , Aa^Fpa      , Aa^Fpa      , Gll^Fp      , Gg          , Gg          , Gg          , Aa^Fpa      , Aa^Fpa      , Gll^Fp      , Gg          , Aa          , Gll^Fp      , Gll^Fp      , Aa          , Hh          , Ha          , Ha          , Gg          , Mm          , Ha          , Mm          , Mm          , Mm          , Ha          , Ha^Vhha     , Ha          , Cud         , Urb         , Rr          , Urb         , Cud         , Cud         , Hh          
Gll^Fp      , Gll^Fp      , Gll^Fp      , Gll^Fp      , Gll^Fp      , Aa          , Gg          , Gll^Fp      , Gll^Fp      , Gll^Fp      , Aa          , Aa          , Gll^Fp      , Gll^Fp      , Gll^Fp      , Gll^Fp      , Gg          , Gg          , Gg          , Gll^Fp      , Gll^Fp      , Gll^Fp      , Gg          , Aa          , Aa          , Aa          , Gg          , Gg          , Aa          , Aa          , Hh          , Mm          , Mm^Xm       , Mm^Xm       , Mm          , Mm          , Mm^Xm       , Ha          , Hh          , Hh          , Urb         , Urb         , Cud         , 5 Kud       , Cud         , Hh          
Gll^Fp      , Gll^Fp      , Gll^Fp      , Gll^Fp      , Gll^Fp      , Aa          , Gg          , Gg          , Aa          , Aa          , Gg          , Gg          , Gg          , Gll^Fp      , Gg          , Gg          , Gll^Fp      , Gll^Fp      , Gll^Fp      , Gg          , Gg          , Gg          , Gg          , Gll^Fp      , Gll^Fp      , Aa          , Gg          , Hh          , Aa          , Aa          , Mm          , Mm^Xm       , Mm          , Mm          , Mm^Xm       , Mm^Xm       , Mm          , Mm          , Hh          , Cud         , Hh          , Urb         , Urb         , Cud         , Hh          , Hh          
Gll^Fp      , Gll^Fp      , Gll^Fp      , Gll^Fp      , Gll^Fp      , Aa          , Aa          , Aa          , Gg          , Aa          , Gg          , Gg          , Gg          , Gg          , Gg          , Gg          , Gg          , Gll^Fp      , Gll^Fp      , Gg          , Gg          , Gg          , Gg          , Gll^Fp      , Gg          , Gg          , Hh          , Hh          , Gg          , Hh          , Mm          , Mm          , Mm          , Mm          , Mm          , Mm          , Mm          , Mm          , Hh          , Hh          , Hh          , Hh          , Hh          , Hh          , Hh          , Hh          
