border_size=1
usage=map

Mm^Xm       , Mm^Xm       , Mm^Xm       , Mm^Xm       , Mm^Xm       , Mm^Xm       , Xu          , Xu          , Xu          , Xu          , Xu          , Xu          , Xu          , Xu          , Xu          , Xu          , Uu          , Uh          , Uu          , Uu          , Uh          , Uu          , Xu          , Xu          , Xu          , Xu          , Xu          , Xu          , Xu          , Mm^Xm       , Mm^Xm       , Mm^Xm       , Mm          , Mm          , Mm          
Mm          , Mm^Xm       , Mm^Xm       , Mm^Xm       , Mm^Xm       , Mm^Xm       , Xu          , Xu          , Xu          , Xu          , Xu          , Xu          , Xu          , Xu          , Xu          , Xu          , Uu          , Uh          , Uu          , Uh          , Uu          , Uu          , Xu          , Xu          , Xu          , Xu          , Xu          , Xu          , Xu          , Mm^Xm       , Mm^Xm       , Mm          , Mm^Xm       , Mm          , Mm          
Mm          , Mm^Xm       , Mm^Xm       , Mm^Xm       , Mm^Xm       , Mm^Xm       , Mm^Xm       , Xu          , Xu          , Xu          , Xu          , Xu          , Xu          , Xu          , Xu          , Uu          , Uu^Uf       , Uu          , Uh          , Uu          , Uu^Ufi      , Uh          , Uh          , Xu          , Xu          , Xu          , Xu          , Xu          , Mm^Xm       , Mm^Xm       , Mm^Xm       , Mm          , Mm          , Mm          , Mm          
Mm          , Mm          , Mm          , Mm^Xm       , Mm^Xm       , Mm^Xm       , Mm^Xm       , Mm^Xm       , Mm^Xm       , Xu          , Xu          , Xu          , Xu          , Xu          , Uu          , Uu          , Uu^Uf       , Uu          , Uu          , Uu^Ufi      , Uu^Ufi      , Uu          , Uu          , Xu          , Xu          , Xu          , Xu          , Mm^Xm       , Mm^Xm       , Mm^Xm       , Mm^Xm       , Mm          , Mm          , Mm          , Hh          
Mm          , Mm^Xm       , Mm^Xm       , Mm          , Mm          , Mm^Xm       , Mm^Xm       , Mm^Xm       , Mm^Xm       , Xu          , Xu          , Xu          , Xu          , Xu          , Uu^Ufi      , Uu          , Uu          , Uu          , Uu          , Uu          , Uu          , Uu          , Uh          , Xu          , Xu          , Xu          , Xu          , Mm^Xm       , Mm^Xm       , Mm^Xm       , Mm          , Mm^Xm       , Mm          , Mm          , Hh          
Hh          , Mm          , Mm          , Mm^Xm       , Mm          , Mm          , Mm          , Mm^Xm       , Mm^Xm       , Mm^Xm       , Xu          , Xu          , Xu          , Xu          , Uu^Ufi      , Uu^Ufi      , Uu          , Uh          , Uu          , Uu^Uf       , Uu          , Uu          , Xu          , Xu          , Xu          , Xu          , Xu          , Mm^Xm       , Mm^Xm       , Mm^Xm       , Hh          , Mm          , Hh          , Hh          , Gg          
Gg          , Hh          , Mm          , Mm          , Mm          , Mm          , Mm          , Mm          , Mm^Xm       , Mm^Xm       , Xu          , Xu          , Xu          , Xu          , Xu          , Uu          , Uu          , Uh          , Ce          , Uu          , Uu          , Uh          , Xu          , Xu          , Xu          , Xu          , Xu          , Xu          , Mm^Xm       , Mm^Xm       , Mm^Xm       , Hh          , Hh          , Gg          , Gs^Fms      
Gg          , Gg          , Hh          , Mm          , Mm          , Mm          , Mm^Xm       , Mm          , Mm^Xm       , Mm^Xm       , Xu          , Xu          , Xu          , Xu          , Xu          , Uh          , Uu          , Ce          , 1 Ke        , Ce          , Uu^Ii       , Uh          , Xu          , Xu          , Xu          , Xu          , Xu          , Xu          , Mm^Xm       , Mm          , Mm          , Mm          , Hh          , Gg          , Gs^Fms      
Gs^Fms      , Gg          , Gg          , Hh          , Mm          , Mm          , Mm          , Mm^Xm       , Mm^Xm       , Mm^Xm       , Mm^Xm       , Xu          , Xu          , Xu          , Uh^Ii       , Uh^Ii       , Uh^Ii       , Ce          , Ce          , Ce          , Uh^Ii       , Uh          , Xu          , Xu          , Xu          , Xu          , Xu          , Mm^Xm       , Mm^Xm       , Mm^Xm       , Mm          , Hh          , Gg          , Gg          , Gs^Fms      
Gs^Fms      , Gs^Fms      , Gg          , Gg          , Hh          , Mm          , Mm          , Mm          , Mm          , Mm^Xm       , Mm^Xm       , Xu          , Xu          , Xu          , Hh^Ii       , Uh^Ii       , Hh^Ii       , Hh^Ii       , Hh^Ii       , Ur^Ii       , Hh^Ii       , Hh^Ii       , Hh^Ii       , Xu          , Xu          , Xu          , Mm^Xm       , Mm^Xm       , Mm^Xm       , Mm          , Hh          , Gg          , Gs^Fms      , Gs^Fms      , Gs^Fms      
Gg          , Gs^Fms      , Gs^Fms      , Gg          , Gg          , Hh          , Hh          , Hh          , Mm          , Mm^Xm       , Mm^Xm       , Mm^Xm       , Mm^Xm       , Mm^Xm       , Hh          , Hh^Ii       , Gg^Ii       , Hh^Ii       , Gg          , Hh^Ii       , Gg^Ii       , Gg^Ii       , Gg^Ii       , Mm^Xm       , Mm^Xm       , Mm^Xm       , Mm^Xm       , Mm^Xm       , Hh          , Hh          , Gg          , Gg          , Gg          , Gg          , Gg          
Gg          , Gg          , Gg          , Gg          , Gg          , Gg          , Gg          , Mm          , Mm          , Mm          , Mm          , Mm^Xm       , Mm          , Mm          , Gg          , Gg          , Gg          , Gg^Ii       , Gg          , Gg          , Gg          , Gg          , Gg          , Hh          , Hh          , Hh          , Gg          , Gg          , Gg          , Gs^Fms      , Gg          , Gs^Fms      , Gs^Fms      , Gs^Fms      , Gg          
Gg          , Gg          , Gg          , Gs^Fms      , Gs^Fms      , Gg          , Gg          , Hh          , Hh          , Mm          , Hh          , Mm          , Hh          , Hh          , Gg          , Gg          , Ch          , Gg          , Gg          , Gg          , Gg          , Gg          , Gg          , Gg          , Gg          , Gg          , Gs^Fms      , Gs^Fms      , Gs^Fms      , Gg          , Gg          , Gs^Fms      , Gs^Fms      , Gs^Fms      , Gg          
Gg          , Gg          , Gg          , Gs^Fms      , Gs^Fms      , Gs^Fms      , Gg          , Gg          , Gg          , Gg          , Gg          , Hh          , Gg          , Gg          , Gs^Fms      , Gg          , Gg          , Gg          , Gg          , Gg^Vhr      , Gg          , Ch          , Gg          , Gg          , Gg          , Gs^Fms      , Gs          , Gs          , Gs^Fms      , Gg          , Qxua        , Gg          , Gg          , Gg          , Gs^Fms      
Qxua        , Qxua        , Qxua        , Gg          , Gg          , Gg          , Gg          , Gg          , Gs^Fms      , Gs^Fms      , Gs^Fms      , Gg          , Gg          , Gg          , Gs^Fms      , Gs^Fms      , Gg          , Gg          , Ch          , Ch          , Ch          , Gg          , Gg          , Gg^Vhr      , Gg          , Gs^Fms      , Gs          , Gs^Fms      , Gg          , Gg          , Qxua        , Qxua        , Qxua        , Gs^Fms      , Qxua        
Qxua        , Qxua        , Qxua        , Gg          , Gg          , Gg          , Qxua        , Gg          , Gg          , Gs^Fms      , Gs^Fms      , Gs^Fms      , Gg          , Gg          , Gs^Fms      , Gg          , Gg^Vhr      , Gg          , Ch          , 2 Kh        , Ch          , Gg          , Gg          , Gg          , Gg          , Gs^Fms      , Gs^Fms      , Gg          , Gg          , Qxua        , Qxua        , Qxua        , Qxua        , Qxua        , Qxua        
Gg          , Gg          , Gg          , Qxua        , Qxua        , Qxua        , Qxua        , Qxua        , Qxua        , Gg          , Gg          , Gg          , Gg          , Gg          , Gg          , Gg          , Gg          , Gg          , Gg          , Ch          , Gg          , Gg          , Gg          , Gg^Vhr      , Gg          , Gg          , Gg          , Gg          , Qxua        , Qxua        , Qxua        , Qxua        , Qxua        , Qxua        , Qxua        
Qxua        , Gg          , Qxua        , Qxua        , Qxua        , Qxua        , Qxua        , Qxua        , Qxua        , Qxua        , Qxua        , Qxua        , Qxua        , Gg          , Qxua        , Gg          , Gg          , Gg          , Ch          , Gg          , Gg          , Gg          , Gg          , Gg          , Qxua        , Gg          , Qxua        , Qxua        , Qxua        , Qxua        , Qxua        , Qxua        , Qxua        , Qxua        , Ss          
Qxua        , Qxua        , Qxua        , Gg          , Gg          , Qxua        , Gg          , Qxua        , Gg^Vhr      , Qxua        , Qxua        , Qxua        , Qxua        , Qxua        , Qxua        , Qxua        , Qxua        , Gg          , Gg          , Gg          , Gg          , Ch          , Gg          , Qxua        , Qxua        , Qxua        , Gg          , Gg          , Qxua        , Qxua        , Gs          , Gg^Vhr      , Qxua        , Ss          , Ds          
Qxua        , Qxua        , Qxua        , Qxua        , Qxua        , Qxua        , Qxua        , Gg          , Gg          , Qxua        , Qxua        , Qxua        , Qxua        , Qxua        , Qxua        , Qxua        , Gg          , Gg          , Gs^Fms      , Gs^Fms      , Gg          , Gg          , Gg          , Gg          , Gg          , Gg          , Gg          , Gg          , Qxua        , Ds          , Gs          , Qxua        , Ss          , Ss          , Ss          
Gg          , Qxua        , Gg          , Qxua        , Qxua        , Qxua        , Qxua        , Qxua        , Qxua        , Qxua        , Qxua        , Qxua        , Qxua        , Qxua        , Gg          , Gg          , Gg          , Gg          , Gs^Fms      , Gs^Fms      , Gs^Fms      , Gg          , Gs^Fms      , Gs^Fms      , Gg          , Gg          , Gg          , Qxua        , Qxua        , Qxua        , Gs          , Ds          , Ds          , Ds          , Ds          
Gg          , Gg          , Gg^Vhr      , Gg          , Qxua        , Qxua        , Qxua        , Qxua        , Qxua        , Qxua        , Gg          , Gg          , Gg          , Gg          , Gs^Fms      , Gg          , Gs^Fms      , Gg          , Gg          , Gs^Fms      , Gg          , Gg          , Gs^Fms      , Gs^Fms      , Gg          , Gg          , Ds          , Qxua        , Ds          , Gs          , Ds          , Ss          , Ds          , Ds          , Ds          
Gg          , Gg          , Gg          , Gg          , Gg          , Gg          , Gg          , Gg          , Gg          , Gg          , Gs^Fms      , Gg          , Gs^Fms      , Gg          , Gg          , Gs^Fms      , Gs^Fms      , Gg          , Gg          , Gg          , Gg          , Gg          , Gg          , Gs^Fms      , Gg          , Ds          , Ds          , Ds          , Ss          , Gs          , Ds          , Ds          , Gs          , Ss          , Ss          
Qxua        , Qxua        , Qxua        , Gg          , Gs^Fms      , Gs^Fms      , Gs^Fms      , Gg          , Gs^Fms      , Gs^Fms      , Gs^Fms      , Gg          , Gg          , Gg          , Gg          , Gg          , Gg          , Gg          , Gg          , Gs^Fms      , Gg          , Gg          , Ds          , Gg          , Ss          , Ds          , Gs          , Ss          , Ds          , Gs          , Gs          , Ds          , Ds          , Gs          , Ds          
Qxua        , Qxua        , Qxua        , Gg          , Gg          , Gs^Fms      , Gg          , Gg          , Gg          , Gs^Fms      , Gg          , Gg          , Gs^Fms      , Gs^Fms      , Gg          , Gg          , Gg          , Gg          , Gg          , Gg          , Ds          , Ds          , Ds          , Ss          , Ds          , Gs          , Ds          , Ss          , Gs          , Ds          , Gs          , Ds          , Ww          , Ww          , Ww          
Qxua        , Qxua        , Qxua        , Qxua        , Gg          , Gg          , Hh          , Gg          , Gg          , Gg          , Gg          , Gg          , Gs^Fms      , Gs^Fms      , Gg          , Gg          , Gs^Fms      , Gs^Fms      , Gs^Fms      , Gg          , Ds          , Ds          , Ds          , Ds          , Ds          , Ds          , Ds          , Ds          , Gs          , Gs          , Ds          , Ww          , Wwr         , Wwr         , Ww          
Gs^Fms      , Gs^Fms      , Gg          , Gg          , Hh          , Hh          , Mm          , Hh          , Mm^Xm       , Hh          , Hh          , Gg          , Gg          , Gs^Fms      , Gg          , Gg          , Gg          , Gs^Fms      , Gg          , Gg          , Ss          , Ds          , Ss          , Ds          , Ss          , Ds          , Gs          , Gs          , Ds          , Ds          , Ww          , Ww          , Wo          , Wo          , Wo          
Gs^Fms      , Gs^Fms      , Hh          , Hh          , Hh          , Mm          , Mm          , Mm          , Mm          , Mm          , Hh          , Gg          , Gg          , Gg          , Gg          , Gg          , Gg          , Gg          , Gg          , Ds          , Ds          , Ss          , Ds          , Ds          , Ss          , Gs          , Ss          , Gs          , Ww          , Ww          , Wwr         , Wwr         , Wo          , Wo          , Wo          
Hh          , Hh          , Mm          , Mm          , Mm^Xm       , Mm^Xm       , Mm^Xm       , Mm          , Mm^Xm       , Mm^Xm       , Mm^Xm       , Hh          , Gg          , Gs^Fms      , Gs^Fms      , Gs^Fms      , Gs^Fms      , Gg          , Gg          , Ds          , Ds          , Ds          , Gs          , Gs          , Ds          , Gs          , Ss          , Ds          , Ww          , Ww          , Wo          , Wo          , Wo          , Wo          , Wo          
Mm          , Hh          , Mm          , Mm^Xm       , Xu          , Xu          , Xu          , Mm^Xm       , Mm^Xm       , Xu          , Xu          , Hh          , Gg          , Gs^Fms      , Gs^Fms      , Gs^Fms      , Gg          , Gg          , Ds          , Ds          , Ss          , Gs          , Gs          , Ds          , Ds          , Gs          , Gs          , Ds          , Ww          , Ww          , Wo          , Wo          , Wo          , Wo          , Wo          
Mm          , Mm          , Mm          , Mm^Xm       , Xu          , Xu          , Mm^Xm       , Mm^Xm       , Xu          , Xu          , Xu          , Hh          , Hh          , Gg          , Gg          , Gg          , Gg          , Gg          , Ss          , Ds          , Ds          , Ds          , Gs          , Ss          , Ds          , Ds          , Ds          , Ww          , Ww          , Ww          , Wo          , Wo          , Wo          , Wo          , Wo          
Mm          , Mm          , Mm^Xm       , Mm^Xm       , Xu          , Xu          , Xu          , Xu          , Xu          , Xu          , Uh          , Uh          , Co          , Gg          , Hh          , Gg          , Hh          , Hh          , Hh          , Ss          , Ds          , Ds          , Gs          , Ds          , Gs          , Ds          , Ds          , Ww          , Ww          , Wo          , Wo          , Wo          , Wo          , Wo          , Wo          
Mm^Xm       , Mm^Xm       , Xu          , Xu          , Xu          , Xu          , Xu          , Xu          , Uh          , Ql          , Ql          , Uh          , Ur          , Co          , Uh          , Hh          , Xu          , Mm^Xm       , Mm^Xm       , Mm          , Hh          , Ss          , Ds          , Gs          , Co          , Gs          , Ds          , Ww          , Ww          , Wo          , Wo          , Wo          , Wo          , Wo          , Wo          
Mm^Xm       , Mm^Xm       , Xu          , Xu          , Xu          , Xu          , Xu          , Uh          , Uu          , Ql          , Ur          , Ur          , Uu          , Uh          , Uh          , Xu          , Xu          , Xu          , Mm^Xm       , Mm          , Mm          , Hh          , Ds          , Ds          , Ds          , Gs          , Ds          , Ww          , Ww          , Wo          , Wo          , Wo          , Wo          , Wo          , Wo          
Xu          , Xu          , Xu          , Xu          , Xu          , Xu          , Uh          , Uu          , Ur          , Ur          , Ql          , Uu          , Uu          , Uu^Uf       , Uu          , Xu          , Xu          , Mm^Xm       , Mm^Xm       , Mm^Xm       , Mm^Xm       , Hh          , Ds          , Co          , Ds          , Ds          , Ds          , Ww          , Ww          , Wo          , Wo          , Wo          , Wo          , Wo          , Wo          
Xu          , Xu          , Xu          , Xu          , Xu          , Xu          , Uh          , Uu          , Uu          , Uu          , Ql          , Ql          , Ur          , Ur          , Uu          , Xu          , Xu          , Mm^Xm       , Xu          , Xu          , Mm^Xm       , Mm          , Ss          , Gs          , Co          , Gs          , Gs          , Ww          , Ww          , Wwr         , Wwr         , Wo          , Wo          , Wo          , Wo          
Xu          , Xu          , Xu          , Xu          , Ql          , Uh          , Ql          , Ur          , Uu^Vud      , Ql          , Uu          , Uu          , Ur          , Uu^Vud      , Uh          , Xu          , Xu          , Xu          , Xu          , Xu          , Mm^Xm       , Mm          , Ss          , Co          , 4 Ko        , Co          , Gs          , Ds          , Ww          , Wwr         , Wo          , Wo          , Wo          , Wo          , Wo          
Xu          , Xu          , Uh          , Uh          , Uu          , Ql          , Uu          , Ur          , Ur          , Uu          , Uu          , Ur          , Ql          , Uh          , Xu          , Xu          , Xu          , Xu          , Mm^Xm       , Mm^Xm       , Mm          , Hh          , Ds          , Co          , Co          , Co          , Gs          , Ds          , Ww          , Wo          , Wo          , Wo          , Wo          , Wo          , Wo          
Xu          , Xu          , Uh          , Uh          , Uu          , Uu^Uf       , Ur          , Uu          , Ql          , Uu          , Uu          , Uu^Uf       , Ql          , Uh          , Xu          , Xu          , Xu          , Xu          , Mm^Xm       , Mm          , Hh          , Hh          , Ds^Vhr      , Ds          , Ds          , Ds          , Ds          , Ww          , Ww          , Wo          , Wo          , Wo          , Wo          , Wo          , Wo          
Xu          , Xu          , Ql          , Ql          , Ur          , Ur          , Uu          , Ql          , Ql          , Ql          , Ur          , Ur          , Ql          , Ql          , Xu          , Xu          , Xu          , Xu          , Mm^Xm       , Mm          , Mm          , Hh          , Hh          , Ds          , Ds          , Ss          , Ds          , Ds          , Ww          , Wo          , Wo          , Wo          , Wo          , Wo          , Wo          
Uh          , Uh          , Ql          , Ql          , Co          , Co          , Co          , Uu          , Ur          , Uu^Vud      , Ur          , Uu          , Uh          , Xu          , Xu          , Xu          , Xu          , Mm^Xm       , Mm          , Mm          , Mm          , Mm          , Hh          , Gs          , Gs          , Ss          , Ds          , Ww          , Wo          , Ww          , Wo          , Wo          , Wo          , Wo          , Wo          
Uh          , Uh          , Uu          , Uu^Uf       , Co          , 3 Ko        , Co          , Ur          , Uu          , Uu          , Ql          , Uh          , Xu          , Xu          , Xu          , Xu          , Xu          , Mm^Xm       , Mm^Xm       , Mm          , Mm          , Mm          , Gs          , Gs          , Ds          , Gs          , Ds          , Ww          , Wo          , Ww          , Wwr         , Wo          , Wo          , Wo          , Wo          
Uu          , Uu          , Ur          , Ur          , Uu          , Co          , Uu^Uf       , Ur          , Uu          , Ql          , Ql          , Uh          , Xu          , Xu          , Xu          , Xu          , Xu          , Mm^Xm       , Mm          , Mm          , Hh          , Hh          , Gs          , Gs          , Ds^Vhr      , Ds          , Ds          , Ww          , Ww          , Ww          , Wo          , Wo          , Wo          , Wo          , Wo          
Ql          , Uu^Vud      , Ql          , Ql          , Ql          , Ur          , Uu          , Ql          , Uu          , Ql          , Uh          , Xu          , Xu          , Xu          , Xu          , Xu          , Mm^Xm       , Mm^Xm       , Mm^Xm       , Mm          , Hh          , Gs          , Ds          , Ds          , Ds          , Ds          , Ds          , Ww          , Ww          , Wo          , Wo          , Wo          , Wo          , Wo          , Wo          
Ql          , Uu          , Uu          , Ql          , Uu          , Ur          , Ur          , Uu          , Ql          , Uh          , Xu          , Xu          , Xu          , Xu          , Xu          , Xu          , Mm^Xm       , Mm^Xm       , Mm          , Mm          , Mm          , Gs          , Ds^Vhr      , Ds          , Gs          , Ds          , Ww          , Ww          , Wo          , Wo          , Wo          , Wo          , Wo          , Wo          , Wo          
Ql          , Ql          , Ql          , Uu          , Uu          , Uu          , Ql          , Ql          , Ql          , Uh          , Xu          , Xu          , Xu          , Xu          , Xu          , Mm^Xm       , Mm^Xm       , Mm          , Mm          , Hh          , Hh          , Gs          , Gs          , Gs          , Gs          , Ds          , Ww          , Ww          , Wo          , Wo          , Wo          , Wo          , Wo          , Wo          , Wo          
