border_size=1
usage=map

Xu          , Xu          , Xu          , Xu          , Xu          , Xu          , Xu          , Xu          , Xu          , Xu          , Xu          , Xu          , Xu          , Xu          , Xu          , Xu          , Xu          , Xu          , Xu          , Xu          , Ql          , Ql          , Re          , Re          , Re          , Ql          , Xu          , Xu          , Xu          , Xu          , Xu          , Xu          , Xu          , Xu          , Xu          , Xu          , Xu          , Xu          , Xu          , Xu          , Xu          , Gg          
Xu          , Xu          , Xu          , Xu          , Xu          , Xu          , Xu          , Xu          , Xu          , Xu          , Xu          , Xu          , Xu          , Xu          , Xu          , Xu          , Xu          , Xu          , Xu          , Xu          , Ql          , Re          , Re          , Re          , Re          , Ql          , Xu          , Xu          , Xu          , Xu          , Xu          , Xu          , Xu          , Xu          , Xu          , Xu          , Xu          , Xu          , Xu          , Xu          , Xu          , Xu          
Xu          , Xu          , Xu          , Xu          , Xu          , Xu          , Xu          , Xu          , Xu          , Xu          , Xu          , Xu          , Xu          , Xu          , Xu          , Xu          , Xu          , Xu          , Xu          , Xu          , Uu^Uf       , Re          , Ce          , Re          , Re          , Uu          , Ql          , Xu          , Xu          , Xu          , Xu          , Xu          , Xu          , Xu          , Xu          , Xu          , Xu          , Xu          , Xu          , Xu          , Xu          , Xu          
Xu          , Xu          , Xu          , Xu          , Xu          , Xu          , Xu          , Xu          , Xu          , Xu          , Ql          , Xu          , Ql          , Xu          , Xu          , Xu          , Ql          , Xu          , Re          , Uu^Uf       , Re          , Re          , Ce          , 1 Ke        , Ce          , Uu          , Uu          , Ql          , Re          , Ql          , Ql          , Xu          , Xu          , Xu          , Ql          , Xu          , Xu          , Xu          , Xu          , Xu          , Xu          , Xu          
Xu          , Xu          , Xu          , Xu          , Xu          , Xu          , Xu          , Xu          , Xu          , Ql          , Uu          , Ql          , Re          , Re          , Re          , Ql          , Uu^Uf       , Re          , Re          , Re          , Re          , Re          , Uu          , Uh          , Re          , Re          , Re          , Re          , Uu          , Re          , Uu^Uf       , Uu^Uf       , Uu          , Re          , Re          , Ql          , Xu          , Xu          , Xu          , Xu          , Xu          , Xu          
Xu          , Xu          , Xu          , Xu          , Xu          , Xu          , Xu          , Xu          , Uu^Uf       , Uu          , Re          , Uu          , Re          , Uu          , Uu          , Uu^Uf       , Uu^Uf       , Re          , Uu          , Uu          , Re          , Uu          , Ql          , Xu          , Xu          , Re          , Re          , Uu          , Uu^Uf       , Re          , Re          , Uu          , Re          , Uu          , Re          , Ql          , Ql          , Xu          , Xu          , Xu          , Xu          , Xu          
Xu          , Xu          , Xu          , Xu          , Xu          , Xu          , Ql          , Uu          , Uu^Uf       , Re          , Uu          , Uu          , Re          , Re          , Re          , Re          , Re          , Re          , Re          , Uu          , Xu          , Ql          , Ql          , Xu          , Xu          , Uu          , Re          , Uu          , Uu          , Uu^Uf       , Uu          , Re          , Uu^Uf       , Re          , Re          , Uu          , Re          , Xu          , Xu          , Xu          , Xu          , Xu          
Xu          , Xu          , Xu          , Xu          , Ql          , Ql          , Ql          , Ql          , Uu          , Re          , Re          , Re          , Uu          , Uu          , Xu          , Uu          , Uu          , Uu          , Re          , Ql          , Xu          , Xu          , Xu          , Xu          , Xu          , Uu          , Uu          , Re          , Uh          , Uh          , Uu          , Uu          , Xu          , Uu^Uf       , Re          , Uu          , Re          , Xu          , Xu          , Xu          , Xu          , Xu          
Xu          , Xu          , Xu          , Xu          , Ql          , Ql          , Ql          , Uu          , Re          , Re          , Uu          , Xu          , Xu          , Xu          , Xu          , Xu          , Ql          , Uu          , Re          , Ql          , Ql          , Xu          , Xu          , Xu          , Xu          , Ql          , Re          , Re          , Re          , Uu          , Xu          , Xu          , Xu          , Xu          , Uu          , Re          , Uu^Uf       , Xu          , Xu          , Xu          , Xu          , Xu          
Xu          , Xu          , Xu          , Xu          , Uu          , Uu          , Uu          , Re          , Re          , Uu          , Xu          , Xu          , Xu          , Xu          , Xu          , Ql          , Uu          , Re          , Uu          , Re          , Re          , Xu          , Xu          , Ql          , Ql          , Ql          , Re          , Uu          , Re          , Uu          , Xu          , Xu          , Xu          , Xu          , Uu          , Re          , Uu^Uf       , Xu          , Xu          , Xu          , Xu          , Xu          
Xu          , Xu          , Xu          , Xu          , Ql          , Re          , Uu^Uf       , Re          , Uu^Uf       , Xu          , Xu          , Xu          , Xu          , Xu          , Xu          , Ql          , Re          , Re          , Xu          , Uu          , Uu          , Re          , Uu          , Uu          , Uh          , Uu          , Uu          , Uu          , Uu          , Re          , Xu          , Xu          , Ql          , Xu          , Re          , Uu          , Re          , Xu          , Xu          , Xu          , Xu          , Xu          
Xu          , Xu          , Xu          , Ql          , Ql          , Re          , Re          , Re          , Uu          , Xu          , Xu          , Xu          , Ql          , Ql          , Uh          , Uh          , Re          , Xu          , Xu          , Xu          , Ql          , Re          , Re          , Uh          , Uu          , Uu^Uf       , Uu^Uf       , Re          , Uu          , Uu          , Uu^Uf       , Xu          , Ql          , Ql          , Uu          , Re          , Re          , Ql          , Xu          , Xu          , Xu          , Xu          
Xu          , Xu          , Xu          , Xu          , Uu          , Uu^Uf       , Uu^Uf       , Re          , Uu          , Xu          , Re          , Xu          , Ql          , Uh          , Re          , Re          , Xu          , Xu          , Xu          , Xu          , Xu          , Ql          , Uu          , Re          , Uu          , Uu          , Re          , Re          , Re          , Re          , Re          , Uu^Uf       , Re          , Re          , Uu          , Re          , Uh          , Ql          , Xu          , Xu          , Xu          , Xu          
Xu          , Xu          , Xu          , Xu          , Uu          , Re          , Uu          , Re          , Re          , Uu          , Re          , Uu^Uf       , Uu^Uf       , Uh          , Re          , Re          , Re          , Xu          , Ql          , Ql          , Ql          , Ql          , Uu          , Re          , Re          , Re          , Re          , Ur          , Uh          , Uh          , Xu          , Re          , Re          , Uu          , Re          , Re          , Uh          , Ql          , Ql          , Xu          , Xu          , Xu          
Xu          , Xu          , Ql          , Uu          , Re          , Re          , Re          , Re          , Uu          , Re          , Re          , Re          , Uu          , Re          , Uu          , Uu          , Re          , Uu          , Uh          , Re          , Re          , Re          , Uu^Uf       , Uu          , Re          , Uu          , Re          , Ur          , Ql          , Ql          , Xu          , Xu          , Xu          , Re          , Uu          , Re          , Uu          , Uh          , Ql          , Xu          , Xu          , Xu          
Xu          , Xu          , Ql          , Ql          , Re          , Uu          , Xu          , Uu          , Xu          , Uu          , Uh          , Re          , Re          , Re          , Re          , Uu          , Uu^Uf       , Uu          , Uu          , Uh          , Xu          , Ur          , Ur          , Uu^Uf       , Re          , Uu          , Uu          , Re          , Ql          , Xu          , Xu          , Xu          , Xu          , Re          , Uu          , Re          , Re          , Uu          , Xu          , Xu          , Xu          , Xu          
Xu          , Xu          , Xu          , Ql          , Re          , Re          , Xu          , Xu          , Xu          , Xu          , Xu          , Uh          , Uu^Uf       , Uu          , Uu          , Re          , Uu^Uf       , Uu^Uf       , Ql          , Xu          , Xu          , Xu          , Xu          , Uu^Uf       , Uu          , Re          , Re          , Uh          , Uu^Uf       , Xu          , Xu          , Xu          , Uu^Uf       , Re          , Re          , Uu          , Uh          , Uu          , Xu          , Xu          , Xu          , Xu          
Xu          , Xu          , Xu          , Ql          , Re          , Uu          , Xu          , Xu          , Xu          , Xu          , Xu          , Xu          , Ql          , Re          , Re          , Re          , Uh          , Uh          , Xu          , Xu          , Xu          , Xu          , Ql          , Ql          , Ur          , Uu          , Re          , Uu^Uf       , Uu          , Uu          , Uu          , Uu          , Uu          , Uu^Uf       , Re          , Uu          , Uh          , Re          , Xu          , Xu          , Xu          , Xu          
Xu          , Xu          , Ql          , Ql          , Re          , Uu          , Uu          , Xu          , Ql          , Ql          , Ql          , Ql          , Ql          , Uu          , Re          , Uu          , Ql          , Ql          , Xu          , Xu          , Xu          , Xu          , Xu          , Ql          , Ur          , Uu          , Uu          , Re          , Re          , Uu          , Re          , Re          , Re          , Uu          , Re          , Re          , Uu          , Re          , Xu          , Xu          , Xu          , Xu          
Xu          , Xu          , Xu          , Ql          , Ql          , Re          , Re          , Uu          , Uu          , Ql          , Rb          , Ql          , Uu          , Uu          , Re          , Uu          , Uu          , Ql          , Re          , Re          , Ur          , Xu          , Uu          , Ql          , Ql          , Ur          , Uh          , Uh          , Uh          , Re          , Xu          , Xu          , Ql          , Re          , Re          , Uu          , Ur          , Xu          , Xu          , Xu          , Xu          , Xu          
Xu          , Xu          , Xu          , Ql          , Ql          , Uu          , Uu          , Re          , Re          , Re          , Re          , Uu          , Re          , Re          , Ur          , Uu          , Uu^Uf       , Re          , Uu          , Uu          , Ur          , Rb          , Rb          , Ql          , Ql          , Uu          , Uu          , Uu          , Ql          , Xu          , Xu          , Xu          , Xu          , Ql          , Re          , Uu          , Ur          , Xu          , Xu          , Xu          , Xu          , Xu          
Xu          , Xu          , Xu          , Xu          , Re          , Re          , Uu          , Re          , Uu          , Uu          , Uu          , Re          , Uh          , Uh          , Ur          , Ur          , Uu^Uf       , Uu^Uf       , Uu          , Ql          , Ql          , Rb          , Uu          , Uu^Uf       , Uu^Uf       , Uu^Uf       , Ur          , Ql          , Xu          , Xu          , Xu          , Xu          , Xu          , Ql          , Re          , Ur          , Re          , Xu          , Xu          , Xu          , Xu          , Xu          
Xu          , Xu          , Xu          , Xu          , Ql          , Re          , Ur          , Re          , Uu^Uf       , Uu^Uf       , Xu          , Ql          , Ql          , Ql          , Xu          , Uu          , Uu          , Ur          , Uu          , Ql          , Uh          , Uh          , Uu          , Uu          , Uu          , Ur          , Uh          , Ql          , Ql          , Xu          , Xu          , Xu          , Xu          , Xu          , Uu          , Re          , Ql          , Xu          , Xu          , Xu          , Xu          , Xu          
Xu          , Xu          , Xu          , Ql          , Uu          , Uu^Uf       , Ur          , Re          , Uu^Uf       , Xu          , Xu          , Xu          , Xu          , Xu          , Xu          , Xu          , Uu          , Ur          , Ur          , Uu          , Chr         , Chr         , Chr         , Uh          , Uu          , Ur          , Uu^Uf       , Uu^Uf       , Uu^Uf       , Xu          , Re          , Xu          , Uu^Uf       , Uu^Uf       , Re          , Re          , Ql          , Ql          , Xu          , Xu          , Xu          , Xu          
Xu          , Xu          , Xu          , Ql          , Uu          , Uu^Uf       , Uh          , Re          , Uu          , Re          , Xu          , Xu          , Xu          , Xu          , Uh          , Uh          , Ql          , Uu^Uf       , Uu          , Uu          , Chr         , 2 Khr       , Chr         , Uh          , Ql          , Ql          , Uh          , Uu          , Uu          , Uu          , Uh          , Re          , Uu          , Uu          , Re          , Uu          , Xu          , Xu          , Xu          , Xu          , Xu          , Xu          
Xu          , Xu          , Xu          , Ql          , Re          , Uu          , Uh          , Re          , Uu          , Re          , Xu          , Ql          , Ql          , Xu          , Ur          , Ql          , Ql          , Uu^Uf       , Uu^Uf       , Uh          , Ur          , Chr         , Ur          , Ur          , Ql          , Ql          , Uh          , Ur          , Uu          , Uu          , Uu          , Uh          , Uu          , Re          , Uu          , Uu          , Xu          , Xu          , Xu          , Xu          , Xu          , Xu          
Xu          , Xu          , Xu          , Xu          , Re          , Uh          , Uu          , Re          , Re          , Uu          , Re          , Ql          , Re          , Ur          , Uu          , Ur          , Uh          , Uu          , Uu          , Uh          , Uu          , Ur          , Uu          , Ur          , Ur          , Uu          , Re          , Ur          , Re          , Uu          , Re          , Uh          , Re          , Re          , Re          , Re          , Xu          , Xu          , Xu          , Xu          , Xu          , Xu          
Xu          , Xu          , Xu          , Xu          , Uu          , Re          , Re          , Re          , Uu          , Re          , Re          , Re          , Re          , Uu          , Re          , Uu          , Uh          , Re          , Uu          , Ql          , Ql          , Uu          , Re          , Ql          , Ql          , Uu          , Re          , Ur          , Uu          , Re          , Uu          , Re          , Uu          , Re          , Re          , Re          , Xu          , Xu          , Xu          , Xu          , Xu          , Xu          
Xu          , Xu          , Xu          , Xu          , Ql          , Uu          , Re          , Uu          , Uu          , Uu          , Uh          , Re          , Uu^Uf       , Re          , Uu^Uf       , Re          , Re          , Re          , Re          , Ql          , Uu          , Re          , Uu^Uf       , Ql          , Ur          , Re          , Ur          , Uu          , Re          , Uu          , Re          , Re          , Uu^Uf       , Uu          , Re          , Uu          , Ql          , Xu          , Xu          , Xu          , Xu          , Xu          
Xu          , Xu          , Xu          , Ql          , Ql          , Uu          , Uu^Uf       , Re          , Ur          , Ur          , Xu          , Uh          , Re          , Uu^Uf       , Re          , Uh          , Re          , Ur          , Uh          , Ur          , Uu          , Uu^Uf       , Uu          , Uu          , Uu          , Uh          , Uh          , Uu          , Re          , Uu          , Re          , Uu^Uf       , Xu          , Uu          , Re          , Uu          , Ql          , Xu          , Xu          , Xu          , Xu          , Xu          
Xu          , Xu          , Xu          , Xu          , Ql          , Re          , Re          , Re          , Uu          , Xu          , Xu          , Ql          , Ql          , Re          , Uu          , Uh          , Re          , Uu          , Uu          , Uh          , Ur          , Uu^Uf       , Xu          , Ql          , Ql          , Re          , Uh          , Re          , Uu          , Uu          , Xu          , Xu          , Xu          , Xu          , Xu          , Re          , Uu          , Ql          , Xu          , Xu          , Xu          , Xu          
Xu          , Xu          , Xu          , Xu          , Xu          , Ql          , Re          , Uu          , Re          , Xu          , Xu          , Ql          , Xu          , Xu          , Uu          , Ur          , Uh          , Re          , Uu          , Uh          , Xu          , Xu          , Xu          , Ql          , Xu          , Re          , Ur          , Re          , Uu^Uf       , Xu          , Xu          , Xu          , Xu          , Xu          , Xu          , Re          , Re          , Uu          , Xu          , Xu          , Xu          , Xu          
Xu          , Xu          , Xu          , Xu          , Xu          , Xu          , Uh          , Re          , Uu          , Re          , Uu^Uf       , Xu          , Uh          , Uu          , Ur          , Ur          , Re          , Re          , Re          , Xu          , Xu          , Xu          , Xu          , Xu          , Xu          , Xu          , Ur          , Re          , Re          , Xu          , Xu          , Xu          , Ql          , Ql          , Uu          , Re          , Uu          , Uu          , Xu          , Xu          , Xu          , Xu          
Xu          , Xu          , Xu          , Xu          , Xu          , Xu          , Uh          , Re          , Re          , Uu          , Ur          , Uu^Uf       , Re          , Uh          , Ql          , Re          , Re          , Uu          , Re          , Xu          , Ql          , Ql          , Xu          , Xu          , Xu          , Uu^Uf       , Uu^Uf       , Re          , Uu          , Xu          , Xu          , Xu          , Ql          , Uu          , Re          , Re          , Re          , Uu          , Xu          , Xu          , Xu          , Xu          
Xu          , Xu          , Xu          , Xu          , Xu          , Xu          , Uu          , Uh          , Re          , Uu          , Ur          , Re          , Xu          , Xu          , Ql          , Ql          , Xu          , Uu          , Uu          , Re          , Re          , Ql          , Uh          , Uu          , Uu          , Re          , Uu          , Uu          , Re          , Re          , Re          , Ql          , Re          , Re          , Uu^Uf       , Uu^Uf       , Xu          , Xu          , Xu          , Xu          , Xu          , Xu          
Xu          , Xu          , Xu          , Xu          , Xu          , Xu          , Uu          , Re          , Uu          , Re          , Re          , Re          , Uh          , Xu          , Xu          , Xu          , Xu          , Xu          , Uu^Uf       , Re          , Uu          , Uu^Uf       , Uu^Uf       , Uh          , Re          , Re          , Re          , Uu          , Uu          , Re          , Uu          , Re          , Re          , Re          , Ql          , Xu          , Xu          , Xu          , Xu          , Xu          , Xu          , Xu          
Xu          , Xu          , Xu          , Xu          , Xu          , Xu          , Xu          , Uu          , Re          , Uu          , Re          , Uu          , Uu          , Uh          , Uu^Uf       , Re          , Re          , Uu          , Re          , Uu          , Re          , Re          , Rb          , Rb          , Uu          , Uu          , Ql          , Re          , Ql          , Uu          , Xu          , Xu          , Xu          , Ql          , Xu          , Xu          , Xu          , Xu          , Xu          , Xu          , Xu          , Xu          
Xu          , Xu          , Xu          , Xu          , Xu          , Xu          , Xu          , Xu          , Xu          , Ql          , Ql          , Re          , Re          , Re          , Re          , Uu^Uf       , Re          , Re          , Uu          , Uu          , Ql          , Rb          , Rb          , Ql          , Ql          , Ql          , Ql          , Ql          , Xu          , Xu          , Xu          , Xu          , Xu          , Xu          , Xu          , Xu          , Xu          , Xu          , Xu          , Xu          , Xu          , Xu          
Xu          , Xu          , Xu          , Xu          , Xu          , Xu          , Xu          , Xu          , Xu          , Ql          , Xu          , Ql          , Ql          , Uu          , Uu          , Re          , Xu          , Ql          , Ql          , Ql          , Xu          , Rb          , Xu          , Xu          , Xu          , Xu          , Xu          , Xu          , Xu          , Xu          , Xu          , Xu          , Xu          , Xu          , Xu          , Xu          , Xu          , Xu          , Xu          , Xu          , Xu          , Xu          
Xu          , Xu          , Xu          , Xu          , Xu          , Xu          , Xu          , Xu          , Xu          , Xu          , Xu          , Xu          , Xu          , Xu          , Xu          , Xu          , Xu          , Xu          , Xu          , Xu          , Ql          , Xu          , Urb         , Ql          , Ql          , Xu          , Xu          , Xu          , Xu          , Xu          , Xu          , Xu          , Xu          , Xu          , Xu          , Xu          , Xu          , Xu          , Xu          , Xu          , Xu          , Xu          
Xu          , Xu          , Xu          , Xu          , Xu          , Xu          , Xu          , Xu          , Xu          , Xu          , Xu          , Xu          , Xu          , Xu          , Xu          , Xu          , Xu          , Xu          , Xu          , Ql          , Uu          , Urb         , Urb         , Uu          , Urb         , Xu          , Xu          , Xu          , Xu          , Xu          , Xu          , Xu          , Xu          , Xu          , Xu          , Xu          , Xu          , Xu          , Xu          , Xu          , Xu          , Xu          
Xu          , Xu          , Xu          , Xu          , Xu          , Xu          , Xu          , Xu          , Xu          , Xu          , Xu          , Xu          , Xu          , Xu          , Xu          , Xu          , Xu          , Xu          , Xu          , Urb         , Urb         , Uu          , Urb         , Uu          , Uu          , Xu          , Xu          , Xu          , Xu          , Xu          , Xu          , Xu          , Xu          , Xu          , Xu          , Xu          , Xu          , Xu          , Xu          , Xu          , Xu          , Xu          
