border_size=1
usage=map

Hh          , Hh          , Mm          , Hh          , Hh          , Gs^Ft       , Ds          , Ss          , Gs          , Gs          , Gs          , Gs          , Gs          , Gs          , Gs          , Gs^Ft       , Gs^Ft       , Gs^Ft       , Ds          , Ww          , Wo          , Wo          , Wo          , Wo          , Wo          , Wo          , Wo          , Wo          , Wo          , Wo          , Wo          , Wo          
Mm          , Mm          , Mm^Xm       , Mm^Xm       , Mm          , Gs^Ft       , Ds          , Ss          , Ds          , Ds          , Ss          , Ss          , Ds          , Ds          , Gs          , Gs^Ft       , Ds          , Gs^Ft       , Ds          , Ww          , Ww          , Wo          , Wo          , Wo          , Wo          , Wo          , Wo          , Wo          , Wo          , Wo          , Wo          , Wo          
Mm          , Mm^Xm       , Mm          , Mm          , Hh          , Hh          , Gs^Ft       , Ds          , Ss          , Ds          , Ds          , Ss          , Ce          , Ds          , Ss          , Ss          , Ss          , Gs          , Gs          , Ds          , Ds          , Wo          , Wo          , Wo          , Wo          , Wo          , Wo          , Wo          , Wo          , Wo          , Wo          , Wo          
Hh          , Mm          , Mm          , Mm^Xm       , Mm          , Hh          , Gs^Ft       , Ds          , Ss          , Gs          , Ss          , Ce          , 1 Ke        , Ss          , Ds          , Ds          , Gs^Ft       , Ss          , Ss          , Gs^Ft       , Gs^Ft       , Ww          , Ww          , Wo          , Wo          , Wo          , Wo          , Wo          , Wo          , Wo          , Wo          , Wo          
Mm          , Mm^Xm       , Mm^Xm       , Mm          , Hh          , Hh          , Gs^Ft       , Gs^Ft       , Ds          , Gs          , Gs          , Ds          , Ce          , Ce          , Gs^Ft       , Gs^Ft       , Gs^Ft       , Ds          , Ss          , Gs^Ft       , Gs          , Ds          , Ww          , Wo          , Wo          , Wo          , Wo          , Wo          , Wo          , Wo          , Wo          , Wo          
Hh          , Mm          , Mm          , Mm^Xm       , Mm          , Hh          , Hh          , Gs^Ft       , Ds          , Gs          , Ss          , Ds          , Ss          , Ds          , Ds          , Ds          , Ds          , Ds          , Ss          , Gs          , Gs          , Ds          , Ww          , Wo          , Wo          , Wo          , Wo          , Wo          , Wo          , Wo          , Wo          , Wo          
Hh          , Hh          , Mm          , Mm          , Mm          , Mm^Xm       , Mm          , Gs^Ft       , Ds          , Gs          , Ds          , Ss          , Gs          , Ss          , Ss          , Ds          , Gs          , Ss          , Gs          , Gs^Ft       , Gs^Ft       , Ds          , Ww          , Wo          , Wo          , Wo          , Wo          , Wo          , Wo          , Wo          , Wo          , Wo          
Hh          , Hh          , Mm^Xm       , Mm          , Mm          , Mm          , Hh          , Ds          , Ds          , Gs^Ft       , Gs^Ft       , Ds          , Ss          , Ds          , Gs          , Gs          , Ss          , Gs          , Ds          , Gs^Ft       , Gs^Ft       , Ds          , Ww          , Wo          , Wo          , Wo          , Wo          , Wo          , Wo          , Wo          , Wo          , Wo          
Hh          , Mm          , Mm          , Mm^Xm       , Mm^Xm       , Mm          , Hh          , Gs^Ft       , Gs^Ft       , Ds          , Ds          , Ds          , Ds          , Gs          , Ss          , Gs          , Ds          , Ds          , Ds          , Gs^Ft       , Ds          , Ds          , Ds          , Wo          , Wo          , Wo          , Wo          , Wo          , Wo          , Wo          , Wo          , Wo          
Mm          , Mm^Xm       , Mm^Xm       , Mm          , Mm          , Mm          , Mm^Xm       , Hh          , Gs^Ft       , Gs^Ft       , Ss          , Ss          , Gs          , Ds          , Ss          , Ds          , Gs          , Ss          , Ss          , Gs^Ft       , Ds          , Gs^Ft       , Ds          , Ww          , Wo          , Wo          , Wo          , Wo          , Wo          , Wo          , Wo          , Wo          
Hh          , Mm          , Mm          , Mm^Xm       , Mm          , Mm          , Mm          , Mm          , Ds          , Ds          , Ss          , Ds          , Ds          , Gs          , Ss          , Gs          , Ds          , Ds          , Ss          , Ss          , Ss          , Ds          , Ds          , Ww          , Wo          , Wo          , Wo          , Wo          , Wo          , Wo          , Wo          , Wo          
Mm          , Mm^Xm       , Mm^Xm       , Mm          , Mm          , Mm^Xm       , Mm          , Hh          , Ds          , Ds          , Gs          , Ss          , Ss          , Ds          , Gs          , Ss          , Ss          , Ds          , Ds          , Ds          , Ds          , Ss          , Gs          , Ww          , Wo          , Wo          , Wo          , Wo          , Wo          , Wo          , Wo          , Wo          
Mm          , Mm          , Mm          , Mm^Xm       , Mm          , Mm          , Hh          , Hh          , Gs          , Ss          , Ss          , Gs          , Gs          , Ss          , Ds          , Gs          , Gs          , Ds          , Gs          , Ds          , Ds          , Ss          , Gs          , Ds          , Ww          , Wo          , Wo          , Wo          , Wo          , Wo          , Wo          , Wo          
Hh          , Mm          , Mm          , Mm          , Mm          , Mm^Xm       , Mm^Xm       , Hh          , Hh          , Ss          , Ss          , Gs          , Gs          , Gs          , Ds          , Gs          , Gs          , Gs          , Ss          , Ds          , Ds          , Ss          , Ds          , Ds          , Ww          , Wo          , Wo          , Wo          , Wo          , Wo          , Wo          , Wo          
Hh          , Hh          , Mm^Xm       , Mm          , Mm          , Mm          , Mm          , Mm^Xm       , Mm          , Gs          , Gs          , Ds          , Ds          , Ds          , Ss          , Ds          , Ds          , Ds          , Ss          , Ds          , Ds          , Ds          , Ds          , Ds          , Ww          , Wo          , Wo          , Wo          , Wo          , Wo          , Wo          , Wo          
Hh          , Mm          , Mm          , Mm^Xm       , Mm^Xm       , Mm          , Mm          , Mm          , Hh          , Ss          , Gs          , Ds          , Ss          , Ss          , Gs^Ft       , Ds          , Gs          , Gs          , Ds          , Ss          , Ss          , Ds          , Ss          , Ds          , Ww          , Wo          , Wo          , Wo          , Wo          , Wo          , Wo          , Wo          
Hh          , Hh          , Hh          , Mm          , Mm          , Mm          , Hh          , Mm          , Mm          , Gs          , Ss          , Ds          , Ss          , Ss          , Ss          , Ds          , Gs          , Gs          , Ds          , Gs^Ft       , Ds          , Ss          , Gs^Ft       , Gs^Ft       , Ds          , Wo          , Wo          , Wo          , Wo          , Wo          , Wo          , Wo          
Mm          , Mm^Xm       , Mm^Xm       , Hh          , Hh          , Hh          , Mm          , Mm          , Hh          , Ss          , Ss          , Ds          , Gs          , Ss          , Ds          , Ds          , Ds          , Ss          , Ss          , Ss          , Ss          , Gs^Ft       , Ds          , Ds          , Ds          , Ww          , Wo          , Wo          , Wo          , Wo          , Wo          , Wo          
Hh          , Mm          , Mm          , Mm^Xm       , Mm          , Mm          , Hh          , Hh          , Hh          , Gs          , Ss          , Ds          , Ds          , Gs          , Gs          , Gs          , Gs          , Gs          , Gs          , Ds          , Ss          , Ss          , Ds          , Ds          , Ds          , Ww          , Wo          , Wo          , Wo          , Wo          , Wo          , Wo          
Hh          , Hh          , Hh          , Mm          , Hh          , Hh          , Mm          , Mm          , Gs^Ft       , Gs^Ft       , Ds          , Gs          , Gs          , Ss          , Ss          , Ds          , Ds          , Ds          , Ds          , Gs^Ft       , Gs^Ft       , Ss          , Ds          , Gs^Ft       , Gs^Ft       , Ww          , Wo          , Wo          , Wo          , Wo          , Wo          , Wo          
Hh          , Hh          , Mm          , Hh          , Mm^Xm       , Mm          , Hh          , Hh          , Gs^Ft       , Gs^Ft       , Ds          , Gs          , Ss          , Ss          , Ds          , Ds          , Gs          , Ds          , Ds          , Gs^Ft       , Ds          , Ds          , Gs          , Ds          , Gs^Ft       , Ds          , Ww          , Wo          , Wo          , Wo          , Wo          , Wo          
Mm          , Mm          , Hh          , Mm          , Mm          , Mm^Xm       , Mm^Xm       , Hh          , Gs^Ft       , Ds          , Gs          , Ds          , Ds          , Ss          , Ss          , Gs          , Gs          , Ds          , Gs^Ft       , Ds          , Gs          , Gs          , Ds          , Ds          , Gs^Ft       , Ds          , Ww          , Wo          , Wo          , Wo          , Wo          , Wo          
Hh          , Mm          , Mm          , Hh          , Mm          , Mm          , Mm          , Mm          , Gs^Ft       , Ds          , Gs          , Gs          , Ds          , Ss          , Chr         , Gs          , Gs          , Gs^Ft       , Gs^Ft       , Ss          , Ss          , Gs          , Gs          , Ds          , Ds          , Ww          , Wo          , Wo          , Wo          , Wo          , Wo          , Wo          
Mm          , Mm^Xm       , Mm^Xm       , Mm          , Hh          , Mm          , Mm          , Ds          , Ss          , Ds          , Ds          , Gs          , Gs          , Chr         , 2 Khr       , Chr         , Ds          , Ds          , Ds          , Ds          , Ss          , Ss          , Ds          , Ds          , Ds          , Ww          , Wo          , Wo          , Wo          , Wo          , Wo          , Wo          
Hh          , Mm          , Mm          , Mm^Xm       , Mm          , Hh          , Hh          , Ds          , Ss          , Ds          , Ss          , Ss          , Ds          , Chr         , Chr         , Chr         , Ss          , Gs          , Ss          , Ss          , Ds          , Ds          , Gs          , Gs          , Ds          , Ww          , Wo          , Wo          , Wo          , Wo          , Wo          , Wo          
Hh          , Hh          , Mm^Xm       , Mm          , Hh          , Hh          , Ds          , Ss          , Ds          , Gs^Ft       , Ss          , Ds          , Ds          , Ds          , Ds          , Ds          , Ds          , Ds          , Gs          , Ss          , Ds          , Gs          , Gs          , Ds          , Ds          , Ww          , Wo          , Wo          , Wo          , Wo          , Wo          , Wo          
Hh          , Mm          , Mm          , Mm^Xm       , Mm^Xm       , Hh          , Mm^Xm       , Ss          , Ss          , Gs^Ft       , Ss          , Ss          , Ss          , Ss          , Ds          , Gs          , Gs          , Gs^Ft       , Gs^Ft       , Ds          , Ss          , Ss          , Ss          , Gs          , Ds          , Ww          , Wo          , Wo          , Wo          , Wo          , Wo          , Wo          
Hh          , Hh          , Mm          , Mm          , Mm          , Mm          , Mm^Xm       , Mm^Xm       , Mm^Xm       , Mm^Xm       , Mm^Xm       , Ss          , Mm^Xm       , Ds          , Xu          , Ds          , Mm^Xm       , Gs          , Xu          , Ss          , Mm^Xm       , Ss          , Mm^Xm       , Gs          , Ds          , Ww          , Wo          , Wo          , Wo          , Wo          , Wo          , Wo          
Mm          , Mm          , Mm^Xm       , Mm^Xm       , Mm          , Gs^Ft       , Gs^Ft       , Mm^Xm       , Ds          , Mm^Xm       , Mm^Xm       , Mm^Xm       , Mm^Xm       , Mm^Xm       , Xu          , Xu          , Mm^Xm       , Xu          , Xu          , Mm^Xm       , Mm^Xm       , Mm^Xm       , Mm^Xm       , Mm^Xm       , Ww          , Ww          , Wo          , Wo          , Wo          , Wo          , Wo          , Wo          
Mm          , Mm^Xm       , Mm          , Mm          , Gs^Ft       , Gs^Ft       , Ds          , Ds          , Ds          , Ss          , Ss          , Ss          , Ss          , Ss          , Gs          , Ds          , Gs          , Ss          , Ss          , Ds          , Gs^Ft       , Mm^Xm       , Ds          , Ds          , Wo          , Wo          , Wo          , Wo          , Wo          , Wo          , Wo          , Wo          
Hh          , Mm          , Hh          , Hh          , Ds          , Gs^Ft       , Gs          , Gs          , Ss          , Ss          , Ss          , Gs          , Gs          , Ds          , Gs          , Ds          , Ds          , Gs          , Gs          , Ss          , Gs          , Gs^Ft       , Ds          , Ww          , Wo          , Wo          , Wo          , Wo          , Wo          , Wo          , Wo          , Wo          
Hh          , Hh          , Hh          , Hh          , Gs^Ft       , Ds          , Ds          , Ds          , Ds          , Ss          , Gs          , Gs          , Gs          , Gs          , Gs          , Gs          , Gs          , Gs          , Gs          , Ss          , Gs          , Ds          , Ww          , Ww          , Wo          , Wo          , Wo          , Wo          , Wo          , Wo          , Wo          , Wo          
