border_size=1
usage=map

Wo          , Wo          , Wo          , Wo          , Ww          , Ww          , Ww          , Ww          , Ww          , Wo          , Wo          , Wo          , Wo^Bsb|     , Wo^Bsb|     , Wo^Bsb|     , Wo          , Wo          , Wo          , Ww          , Ww          , Ww          , Wo          , Wo          , Wo          , Wo          , Wo          
Wo          , Wo          , Ww          , Ww          , Ww          , Ww          , Ww          , Ww          , Ww          , Ww          , Ww          , Wo          , Ww^Bsb|     , Wo^Bsb|     , Wo^Bsb|     , Wo          , Ww          , Ww          , Ww          , Ww          , Ww          , Ww          , Ww          , Wo          , Wo          , Wo          
Wo          , Wo          , Ww          , Ww          , Ch          , Ch          , Ch          , Rr          , Ch          , Ww          , Ww          , Ww          , Ww^Bsb|     , Ww^Bsb|     , Ww^Bsb|     , Ww          , Ww          , Ww          , Ch          , Ch          , Ch          , Ww          , Ww          , Wo          , Wo          , Wo          
Ww          , Ww          , Ww          , Ww          , Ch          , Ch          , Rr          , Rr          , Ch          , Ch          , Rr          , Ww          , Ch          , Ww^Bsb|     , Ww^Bsb|     , Ww          , Ch          , Rr          , Rr          , Ch          , Ch          , Ww          , Ww          , Ww          , Wo          , Wo          
Ww^Bsb\     , Ww          , Ch          , Rr          , Rr          , Rr          , Rr          , Gg          , Gg          , Gg          , Rr          , Ch          , Ch          , Ch          , Rr          , Ch          , Ch          , Rr          , Rr          , Rr          , Rr          , Ch          , Ww          , Ww          , Ww          , Wo          
Ww^Bsb\     , Ww^Bsb\     , Ch          , Ch          , Gg          , Gg          , Gs^Vh       , Rr          , Rr          , Rr          , Rr^Vh       , Rr          , Rr          , Rr          , Rr^Vh       , Rr          , Rr          , Rr          , Gs^Vh       , Rr          , Rr          , Rr          , Ch          , Ww          , Ww          , Wo          
Ww^Bsb\     , Ww^Bsb\     , Ww^Bsb\     , Ch          , Rr          , Gg          , Gg          , Gg          , Rr          , Rr          , Rr          , Rr          , Rr          , Rr          , Rr          , Rr          , Rr          , Gg          , Gg          , Gg          , Gg          , Ch          , Ch          , Ww          , Ww^Bsb/     , Wo^Bsb/     
Wo          , Ww^Bsb\     , Ww^Bsb\     , Rr          , Ch          , Rr          , Rr          , Gg          , Rr          , Rr          , Gll^Fmf     , Rr          , Gll^Fmf     , Rr          , Gll^Fmf     , Gll^Fmf     , Gll^Fmf     , Rr          , Rr          , Gg          , Gg          , Ch          , Ww^Bsb/     , Ww^Bsb/     , Ww^Bsb/     , Wo^Bsb/     
Wo          , Ww          , Ww          , Ch          , Ch          , Ch          , Rr          , Rr          , Cud         , Gll^Fmf     , Gll^Fmf     , Gll^Fmf     , Cud         , Rr          , Cud         , Gll^Fmf     , Gll^Fmf     , Gll^Fmf     , Rr          , Gs^Vh       , Gg          , Rr          , Ww^Bsb/     , Ww^Bsb/     , Ww^Bsb/     , Wo^Bsb/     
Wo          , Ww          , Ww          , Ww          , Gg          , Rr          , Rr          , Rr          , Rr          , Gll^Fmf     , Gll^Fmf     , Gll^Fmf     , Rr          , Rr          , Rr          , Cud         , Gll^Fmf     , Gll^Fmf     , Rr          , Gg          , Rr          , Rr          , Ch          , Ww^Bsb/     , Ww          , Ww          
Wo          , Wo          , Ww          , Ww          , Gg          , Gg          , Rr          , Cud         , Cud         , Rr          , Rr          , Rr          , Cud         , Cud         , Cud         , Rr          , Rr          , Gll^Fmf     , Rr          , Rr          , Gg          , Gg          , Ch          , Ch          , Ww          , Ww          
Wo          , Wo          , Ww          , Ww          , Gg          , Gs^Vh       , Rr          , Cud         , Rr          , Rr          , Rr          , Rr          , Cud         , 2 Kud       , Cud         , Rr          , Rr          , Rr          , Rr          , Rr          , Gg          , Gs^Vh       , Gg          , Ch          , Ww          , Ww          
Wo^Bsb\     , Ww          , Ww          , Ww          , Ch          , Gg          , Rr          , Rr          , Gll^Fmf     , Gll^Fmf     , Cud         , Rr          , Rr          , Cud         , Rr          , Rr          , Gll^Fmf     , Cud         , Cud         , Rr          , Rr          , Gg          , Ch          , Ww          , Ww          , Ww          
Wo^Bsb\     , Ww^Bsb\     , Ww^Bsb\     , Ch          , Ch          , Gg          , Rr          , Rr          , Gll^Fmf     , Gll^Fmf     , Gll^Fmf     , Cud         , Cud         , Rr          , Gll^Fmf     , Gll^Fmf     , Gll^Fmf     , Cud         , Rr          , Rr          , Rr          , Ch          , Ch          , Ww          , Ww          , Wo          
Ww^Bsb\     , Ww^Bsb\     , Ww^Bsb\     , Ch          , Gg          , Gg          , Rr          , Rr          , Rr          , Gll^Fmf     , Gll^Fmf     , Cud         , Rr          , Rr          , Gll^Fmf     , Gll^Fmf     , Gll^Fmf     , Cud         , Rr          , Rr          , Rr          , Ch          , Ww^Bsb\     , Ww          , Ww          , Wo          
Ww          , Ww^Bsb\     , Ch          , Rr          , Rr          , Rr          , Rr          , Rr          , Gg          , Rr          , Rr          , Rr          , Rr          , Gll^Fmf     , Gll^Fmf     , Gll^Fmf     , Rr          , Rr          , Gg          , Gs^Vh       , Rr          , Rr          , Ww^Bsb\     , Ww^Bsb\     , Ww^Bsb\     , Wo          
Ww          , Ww          , Ch          , Ch          , Gg          , Gs^Vh       , Rr          , Gg          , Gs^Vh       , Gg          , Gg          , Rr          , Rr          , Cud         , Cud         , Cud         , Rr          , Rr          , Gg          , Gg          , Gg          , Rr          , Rr          , Ww^Bsb\     , Ww^Bsb\     , Wo^Bsb\     
Ww          , Ww          , Ch          , Ch          , Rr          , Gg          , Rr          , Gg          , Gg          , Gg          , Gg          , Rr          , Gg          , Rr          , Rr          , Rr          , Rr          , Rr          , Rr          , Gg          , Gs^Vh       , Gg          , Ch          , Ww^Bsb\     , Ww^Bsb\     , Wo^Bsb\     
Ww          , Ww          , Rr          , Rr          , Gg          , Rr          , Rr          , Gg          , Gg          , Gg          , Rr          , Rr          , Gg          , Gg          , Rr          , Gg          , Gs^Vh       , Rr          , Rr          , Gg          , Gg          , Ch          , Ch          , Ww          , Ww          , Wo^Bsb\     
Ww          , Ww          , Ch          , Gg          , Gg          , Ch          , 1 Ch^Vhc    , Rr          , Rr          , Gg          , Rr          , Gs^Vh       , Gg          , Gg          , Rr          , Gg          , Gg          , Gg          , Gg          , Rr          , Rr          , Ch          , Ww^Bsb\     , Ww          , Ww          , Wo          
Ww          , Ww          , Ch          , Ch          , Gg          , Ch          , Ch          , Ch          , Rr          , Rr          , Gg          , Gg          , Gg          , Gg          , Rr          , Gg          , Gg          , Gg          , Gg          , Gg          , Ch          , Ww^Bsb\     , Ww^Bsb\     , Ww^Bsb\     , Wo^Bsb\     , Wo          
Ww          , Ww          , Ww          , Ch          , Rr          , Rr          , Gg          , Gg          , Ch          , Rr          , Rr          , Gg          , Ch          , Rr          , Rr          , Rr          , Ch          , Gg          , Rr          , Ch          , Ch          , Ww^Bsb\     , Ww^Bsb\     , Wo^Bsb\     , Wo^Bsb\     , Wo^Bsb\     
Wo          , Ww          , Ww          , Rr          , Ch          , Ch          , Ch          , Gg          , Ch          , Ch          , Ww^Bsb|     , Ch          , Ch          , Rr          , Rr          , Ch          , Ch          , Ch          , Ww^Bsb|     , Ch          , Ww          , Ww          , Ww          , Wo^Bsb\     , Wo^Bsb\     , Wo^Bsb\     
Wo          , Ww          , Ww          , Ww          , Ww          , Ch          , Ww          , Ww          , Ww          , Ww^Bsb|     , Ww^Bsb|     , Ww^Bsb|     , Ww          , Ww          , Ww          , Ch          , Ww          , Ww^Bsb|     , Ww^Bsb|     , Ww^Bsb|     , Ww          , Ww          , Wo          , Wo          , Wo          , Wo^Bsb\     
Wo          , Wo          , Wo          , Ww          , Ww          , Ww          , Ww          , Ww          , Ww          , Ww^Bsb|     , Wo^Bsb|     , Ww^Bsb|     , Ww          , Ww          , Ww          , Ww          , Ww          , Ww^Bsb|     , Wo^Bsb|     , Ww^Bsb|     , Wo          , Wo          , Wo          , Wo          , Wo          , Wo          
