border_size=1
usage=map

Mm          , Mm          , Mm          , Hhd         , Hh          , Hd          , Hd          , Dd          , Dd          , Dd          , Dd          , Dd          , Dd          , Dd          , Ds          , Ds          , Ww          , Ww          , Ww          , Ww          , Wo          , Wo          , Wo          , Ww          , Ww          , Gs          , Gs          , Gs          , Gs          , Gs          , Gs          , Hd          , Hd          , Hd          , Hhd         , Dd          , Dd          , Dd          , Dd          , Dd          , Dd          , Dd          , Dd          , Dd          
Mm          , Mm          , Mm          , Hhd         , Hhd         , Hh          , Hh          , Hd          , Hd          , Dd          , Hd          , Hd          , Hd          , Ds          , Ww          , Ww          , Ww          , Ww          , Wo          , Wo          , Ww          , Ww          , Ww          , Wo          , Ww          , Ww          , Ww          , Gs          , Gs          , Gs          , Gs          , Gs          , Gs          , Hd          , Hhd         , Dd          , Dd          , Dd          , Dd          , Dd          , Dd          , Dd          , Dd          , Dd          
Mm          , Mm          , Mm          , Mm          , Mm          , Mm          , Mm          , Hhd         , Hhd         , Hhd         , Hhd         , Hh          , Ww          , Ww          , Wo          , Wo          , Ww          , Wo          , Ww          , Ww          , Wwf         , Wwf         , Mm          , Ww          , Ww          , Wo          , Wo          , Ww          , Ww          , Gs          , Gs          , Gs          , Gs          , Gs          , Hd          , Dd          , Dd          , Dd          , Dd          , Dd          , Dd          , Dd          , Dd          , Dd          
Mm          , Mm          , Mm          , Mm          , Mm          , Mm          , Mm          , Mm          , Mm          , Hh          , Hh          , Hh          , Ww          , Wo          , Ww          , Ww          , Mm          , Ww          , Ch          , Gg          , Rrc         , Ch          , Mm          , Mm          , Mm          , Ww          , Wo          , Ww          , Ww          , Gs          , Gs          , Gs          , Gs          , Gs          , Gs          , Hd          , Dd          , Dd          , Dd          , Dd          , Dd          , Dd          , Dd          , Dd          
Mm          , Mm          , Mm          , Mm          , Mm          , Mm          , Mm          , Mm          , Mm          , Hhd         , Hhd         , Ww          , Wo          , Ww          , Wwf         , Mm          , Mm          , Mm          , Rrc         , Rrc         , Ch          , Rrc         , Rrc         , Mm          , Rrc         , Ww          , Ww          , Ww          , Ww          , Gs          , Gs          , Gs          , Gs          , Gs          , Gs          , Hhd         , Dd          , Dd          , Dd          , Dd          , Dd          , Dd          , Dd          , Dd          
Mm          , Mm          , Mm          , Mm          , Mm          , Mm          , Mm          , Mm          , Mm          , Mm          , Hhd         , Ww          , Ww          , Ww          , Rrc         , Ch          , Gg          , Gg^Vhc      , Rrc         , Ch          , 2 Kh        , Ch          , Rrc^Vhc     , Rrc         , Mm          , Ch          , Ww          , Wo          , Ww          , Gs          , Gs          , Gs          , Gs          , Gs          , Gs          , Hhd         , Hd          , Dd          , Dd          , Dd          , Dd          , Dd          , Dd          , Dd          
Mm          , Mm          , Mm          , Mm          , Mm          , Mm          , Mm          , Mm          , Mm          , Hh          , Hd          , Hd          , Wwf         , Wwf         , Ch          , Rrc         , Rrc         , Rrc         , Rrc         , Ch          , Ch          , Ch          , Rrc         , Mm          , Mm          , Mm          , Ww          , Wo          , Ww          , Gs          , Gs          , Gs          , Gs          , Gs          , Gs          , Gs          , Hd          , Dd          , Dd          , Dd          , Dd          , Dd          , Dd          , Dd          
Mm          , Mm          , Mm          , Mm          , Mm          , Mm          , Mm          , Mm          , Hh          , Hh          , Hh          , Hd          , Wwf         , Wwf         , Ww          , Ch          , Mm          , Gg^Vhc      , Ch          , Rrc         , Rrc         , Rrc         , Wwf         , Hh          , Wwf         , Hh          , Ww          , Wo          , Ww          , Gs          , Gs          , Gs          , Gs          , Re^Vct      , Gs          , Gs          , Gs          , Hhd         , Dd          , Dd          , Dd          , Dd          , Dd          , Dd          
Mm          , Mm          , Mm          , Mm          , Mm          , Mm          , Mm          , Mm          , Hh          , Hhd         , Hd          , Hh          , Ww          , Wo          , Ww          , Mm          , Mm          , Mm          , Wwf         , Wwf         , Wwf         , Rrc         , Wwf         , Wwf         , Wwf         , Ww          , Ww          , Wo          , Ww          , Gs          , Gs          , Gs          , Gs          , Gs          , Gs          , Gs          , Gs          , Hhd         , Hd          , Dd          , Dd          , Dd          , Dd          , Dd          
Mm          , Mm          , Mm          , Mm          , Mm          , Mm          , Mm          , Mm          , Mm          , Hhd         , Hd          , Hh          , Ww          , Wo          , Wo          , Ww          , Ww          , Wwf         , Wwf         , Wwf         , Rrc         , Rrc         , Rrc         , Wwf         , Gg^Vhc      , Ch          , Ch          , Ww          , Wo          , Ww          , Gs          , Gs          , Gs          , Gs          , Gs          , Gs          , Gs          , Gs          , Hhd         , Hd          , Dd          , Dd          , Dd          , Dd          
Mm          , Mm          , Mm          , Mm          , Mm          , Mm          , Mm          , Mm          , Mm          , Hhd         , Hhd         , Hd          , Ww          , Wo          , Ww          , Ww          , Ww          , Ww          , Ch          , Gg^Vhc      , Rrc         , Gg          , Gg^Vhc      , Rrc         , Rrc         , Rrc         , Rrc         , Ww          , Wo          , Ww          , Gs          , Gs          , Gs          , Gs          , Gs          , Gs          , Gs          , Gs          , Hhd         , Hd          , Dd          , Dd          , Dd          , Dd          
Mm          , Mm          , Mm          , Mm          , Mm          , Mm          , Mm          , Mm          , Mm          , Mm          , Hh          , Hd          , Hd          , Ww          , Ww          , Wo          , Wo          , Ww          , Ww          , Gg          , Rrc         , Gg          , Gg          , Gg          , Rrc         , Gg          , Ch          , Wwf         , Wwf         , Wwf         , Gs          , Gs          , Gs          , Gs          , Gd          , Gd          , Gd          , Gs          , Hd          , Dd          , Dd          , Dd          , Dd          , Dd          
Mm          , Mm          , Mm          , Mm          , Mm          , Mm          , Mm          , Mm          , Mm          , Mm          , Hh          , Hhd         , Hhd         , Hhd         , Gs          , Ww          , Ww          , Wo          , Wwf         , Wwf         , Ww          , Ch          , Ww          , Rrc         , Ch          , Gg          , Ww          , Ww          , Wo          , Wwf         , Gs          , Gs          , Gs          , Gs          , Gd          , Gd^Fdf      , Gll^Fmf     , Gd          , Hd          , Hhd         , Hhd         , Dd          , Hd          , Dd          
Mm          , Mm          , Mm          , Mm          , Mm          , Mm          , Mm          , Mm          , Hhd         , Hh          , Gs          , Gs          , Gs          , Gs          , Gs          , Gs          , Gs          , Wwf         , Wwf         , Wo          , Wo          , Ww          , Wo          , Wwf         , Ww          , Ww          , Wo          , Wo          , Ww          , Ww          , Gs          , Gs          , Gs          , Gd          , Gll^Fmf     , Gd^Fdf      , Gll^Fmf     , Gd          , Gd          , Hd          , Gs          , Hd          , Hd          , Dd          
Mm          , Mm          , Mm          , Mm          , Mm          , Mm          , Mm          , Hhd         , Gs          , Gs          , Gs          , Gs          , Gs          , Gs          , Gs          , Gs          , Gs          , Gs          , Gs          , Ww          , Wo          , Wo          , Ww          , Wwf         , Wwf         , Ww          , Ww          , Ww          , Gs          , Gs          , Gs          , Gs          , Gs          , Gd          , Gll^Fmf     , Gd^Fdf      , Gd^Fdf      , Gll^Fmf     , Gd          , Gs          , Gs          , Hhd         , Hhd         , Dd          
Mm          , Mm          , Mm          , Mm          , Mm          , Mm          , Mm          , Hhd         , Gs          , Gs          , Gs          , Gs          , Gs          , Gs          , Gd          , Gs          , Gs          , Gs          , Gs          , Ww          , Wo          , Ww          , Gs          , Gs          , Gs          , Gs          , Gs          , Gs          , Gs          , Gs          , Gs          , Gs          , Gd          , Gd          , Gll^Fmf     , Gll^Fmf     , Gd^Fdf      , Gll^Fmf     , Gd          , Gs          , Gs          , Gs          , Hd          , Hd          
Mm          , Mm          , Mm          , Mm          , Mm          , Mm          , Hh          , Hh          , Gs          , Gs          , Gs          , Gs          , Gd          , Gd          , Gd^Fdf      , Gd          , Gd          , Gs          , Gs          , Ww          , Wo          , Ww          , Gs          , Gs          , Gs          , Gs          , Gs          , Gs          , Gs          , Gs          , Gs          , Gs          , Gd          , Gd          , Gd          , Gll^Fmf     , Gd^Fdf      , Gll^Fmf     , Gd          , Gs          , Gs          , Gs          , Hd          , Hhd         
Mm          , Mm          , Mm          , Mm          , Mm          , Mm          , Hh          , Gs          , Ce          , Ce          , Ce          , Gs          , Gd          , Gd^Fdf      , Gd^Fdf      , Gd          , Gd          , Gd          , Gs          , Ww          , Ww          , Ww          , Gs          , Gs          , Gs          , Gs          , Gs          , Gs          , Gs          , Gs          , Gs          , Gd          , Gd^Fdf      , Gd          , Gd          , Gd          , Gd          , Gd          , Gs          , Gs          , Gs          , Gs          , Gs          , Hd          
Mm          , Mm          , Mm          , Mm          , Mm          , Hhd         , Gs          , Gs          , Gs          , Gs          , Gs          , Gs          , Gd          , Gd^Fdf      , Gll^Fmf     , Gll^Fmf     , Gll^Fmf     , Gd          , Gs          , Ww          , Wwf         , Wwf         , Ww          , Gs          , Gs          , Re^Vct      , Gs          , Gs          , Gs          , Gs          , Gd          , Gd          , Gd^Fdf      , Gll^Fmf     , Gll^Fmf     , Gd          , Gs          , Gs          , Gs          , Gs          , Gs          , Gs          , Gs          , Gs          
Mm          , Mm          , Mm          , Mm          , Hhd         , Hhd         , Gs          , Gs          , Ce          , Gs          , Gs          , Gs          , Gd          , Gd^Fdf      , Gd^Fdf      , Gll^Fmf     , Gd^Fdf      , Gd          , Gs          , Gs          , Gs          , Wwf         , Ww          , Ww          , Gs          , Gs          , Gs          , Gs          , Gs          , Gs          , Gd          , Gll^Fmf     , Gd^Fdf      , Gll^Fmf     , Gll^Fmf     , Gd          , Gs          , Gs          , Gs          , Gs          , Gs          , Gs          , Gs          , Gs          
Mm          , Mm          , Mm          , Mm          , Hh          , Gs          , Gs          , Re^Vct      , 3 Ke        , Ce          , Gs          , Gs          , Gs          , Gd          , Gd          , Gd^Fdf      , Gd          , Gd          , Gs          , Re^Vct      , Gs          , Ww          , Wo          , Ww          , Gd          , Gs          , Gs          , Gs          , Gd          , Gd          , Gd          , Gll^Fmf     , Gll^Fmf     , Gd^Fdf      , Gd^Fdf      , Gd          , Gs          , Gs          , Gs          , Gs          , Gs          , Gs          , Gs          , Gs          
Mm          , Mm          , Mm          , Hh          , Gs          , Gs          , Gs          , Re^Vct      , Ce          , Ce          , Gs          , Ce          , Gs          , Gs          , Gs          , Gd          , Gs          , Gs          , Gs          , Gs          , Ww          , Ww          , Wo          , Ww          , Gd^Fdf      , Gd          , Gd          , Gd          , Gd          , Gd          , Gd          , Gd^Fdf      , Gd^Fdf      , Gd^Fdf      , Gd          , Gd          , Gs          , Gs          , Gs          , Gs          , Gs          , Gs          , Gs          , Gs          
Mm          , Mm          , Mm          , Hh          , Gs          , Gs          , Ce          , Gs          , Gs          , Gs          , Ce          , Ce          , Gs          , Gs          , Gs          , Gs          , Gs          , Gs          , Gs          , Ww          , Wo          , Wo          , Ww          , Ww          , Gll^Fmf     , Gll^Fmf     , Gll^Fmf     , Gd          , Gd          , Gd          , Gd          , Gd          , Gd          , Gd          , Gs          , Gs          , Gs          , Gs          , Gs          , Gs          , Gs          , Gs          , Gs          , Gs          
Mm          , Mm          , Hhd         , Hhd         , Gs          , Gs          , Ce          , Gs          , Gs          , Gs          , Gd          , Gs          , Gs          , Gs          , Gs          , Gs          , Gs          , Gs          , Gs          , Ww          , Ww          , Ww          , Gd          , Gd^Fdf      , Gd^Fdf      , Gd^Fdf      , Gd          , Gd          , Gs          , Gs          , Gs          , Gs          , Gs          , Gs          , Gs          , Ce          , Ce          , Gs          , Gs          , Gs          , Re^Vct      , Gs          , Gs          , Gs          
Mm          , Mm          , Hh          , Gs          , Gs          , Gs          , Gs          , Ce          , Gd          , Gd          , Gd^Fdf      , Gd          , Gd          , Gs          , Gs          , Gs          , Gs          , Gs          , Gs          , Ww          , Wo          , Ww          , Gd          , Gd^Fdf      , Gll^Fmf     , Gd^Fdf      , Gd          , Gs          , Gs          , Gs          , Ce          , Gs          , Gs          , Gs          , Gs          , Gs          , Ce          , Gs          , Gs          , Gs          , Gs          , Gs          , Gs          , Gs          
Hh          , Hh          , Gs          , Gs          , Gs          , Gs          , Gs          , Gs          , Gd          , Gd^Fdf      , Gll^Fmf     , Gll^Fmf     , Gd          , Gs          , Gs          , Gs          , Gs          , Gs          , Gs          , Ww          , Wo          , Ww          , Gd          , Gd          , Gd          , Gd          , Gs          , Gs          , Gs          , Ce          , Gs          , Gs          , Re^Vct      , Ce          , Ce          , Gs          , Gs          , Gs          , Gs          , Gs          , Gs          , Gs          , Gs          , Gs          
Gs          , Gs          , Gs          , Gs          , Gs          , Gs          , Gs          , Gs          , Gd          , Gd^Fdf      , Gd^Fdf      , Gll^Fmf     , Gll^Fmf     , Gd          , Gs          , Gs          , Gs          , Re^Vct      , Gs          , Ww          , Wo          , Ww          , Gd          , Gd          , Gd          , Gs          , Gs          , Gs          , Gs          , Ce          , Gs          , Gs          , Re^Vct      , 4 Ke        , Ce          , Gs          , Gs          , Gs          , Gs          , Gs          , Gs          , Gs          , Gs          , Gs          
Gs          , Gs          , Gs          , Gs          , Gs          , Gs          , Gs          , Gs          , Gd          , Gll^Fmf     , Gd^Fdf      , Gll^Fmf     , Gd^Fdf      , Gd          , Gs          , Gs          , Gs          , Gs          , Ww          , Ww          , Ww          , Ww          , Gd          , Gd          , Gd          , Gs          , Gs          , Gs          , Gs          , Gs          , Gs          , Gs          , Gs          , Ce          , Gs          , Gs          , Gd          , Gd          , Gd          , Gs          , Gs          , Gs          , Gs          , Gs          
Gs          , Gs          , Gs          , Gs          , Gs          , Gs          , Gs          , Gs          , Gs          , Gd          , Gd          , Gd^Fdf      , Gd          , Gd          , Gs          , Gs          , Gs          , Gs          , Ww          , Wo          , Ww          , Gd          , Gd^Fdf      , Gd          , Gd          , Gd          , Gs          , Gs          , Gs          , Gs          , Gs          , Gs          , Gs          , Gs          , Gs          , Gs          , Gd          , Gd^Fdf      , Gll^Fmf     , Gd          , Gs          , Gs          , Gs          , Gs          
Gs          , Gs          , Gs          , Gs          , Gs          , Gs          , Gs          , Gs          , Gs          , Gs          , Gs          , Gd          , Gs          , Gs          , Gs          , Gs          , Gs          , Gs          , Ww          , Wo          , Ww          , Gd          , Gd^Fdf      , Gll^Fmf     , Gd          , Gd          , Gd          , Gs          , Gs          , Gs          , Gs          , Ce          , Ce          , Ce          , Gs          , Gd          , Gll^Fmf     , Gd^Fdf      , Gll^Fmf     , Gd          , Gd          , Gs          , Gs          , Gs          
Gs          , Gs          , Gs          , Gs          , Gs          , Re^Vct      , Gs          , Gs          , Gs          , Gs          , Gs          , Gs          , Gs          , Gs          , Gs          , Gs          , Gs          , Gs          , Ww          , Wo          , Ww          , Gll^Fmf     , Gll^Fmf     , Gll^Fmf     , Gll^Fmf     , Gd          , Gll^Fmf     , Gd          , Gd          , Gs          , Gs          , Gs          , Gs          , Gs          , Gs          , Gd          , Gll^Fmf     , Gd^Fdf      , Gd^Fdf      , Gll^Fmf     , Gd^Fdf      , Gd          , Gs          , Gs          
Gs          , Gs          , Gs          , Gs          , Gs          , Gs          , Gs          , Gs          , Gs          , Gs          , Gs          , Gs          , Gs          , Gs          , Gs          , Gs          , Gs          , Ww          , Wo          , Ww          , Gd          , Gd^Fdf      , Gll^Fmf     , Gll^Fmf     , Gll^Fmf     , Gll^Fmf     , Gd^Fdf      , Gd^Fdf      , Gd          , Gs          , Gs          , Gs          , Gs          , Gs          , Gd          , Gd          , Gd          , Gll^Fmf     , Gd          , Gd^Fdf      , Gd          , Gd          , Gs          , Gs          
Gs          , Gs          , Gs          , Gs          , Gd          , Gd          , Gd          , Gs          , Gs          , Gs          , Gs          , Gs          , Gs          , Gs          , Gs          , Gs          , Gs          , Ww          , Ww          , Ww          , Ww          , Gd^Fdf      , Gd^Fdf      , Gd^Fdf      , Gd^Fdf      , Gd^Fdf      , Gll^Fmf     , Gd          , Gd          , Gs          , Gs          , Gs          , Gs          , Gs          , Gd          , Gll^Fmf     , Gll^Fmf     , Gd          , Gs          , Gd          , Gs          , Gs          , Gs          , Gs          
Gs          , Gs          , Gs          , Gd          , Gd^Fdf      , Gll^Fmf     , Gll^Fmf     , Gd          , Gd          , Gs          , Gs          , Gs          , Gs          , Re^Vct      , Gs          , Gs          , Gs          , Gs          , Ww          , Wo          , Ww          , Gd          , Gd          , Gll^Fmf     , Gll^Fmf     , Gll^Fmf     , Gd          , Gd          , Gs          , Gs          , Re^Vct      , Gs          , Gs          , Gs          , Gd          , Gd^Fdf      , Gll^Fmf     , Gd          , Gs          , Gs          , Gs          , Gs          , Gs          , Gs          
Gs          , Gs          , Gs          , Gd          , Gd^Fdf      , Gll^Fmf     , Gll^Fmf     , Gll^Fmf     , Gd^Fdf      , Gd          , Gs          , Gs          , Gs          , Gs          , Gs          , Gs          , Gs          , Gs          , Gs          , Ww          , Wo          , Ww          , Wwf         , Gd          , Gd          , Gd          , Gs          , Gs          , Gs          , Gs          , Gs          , Gs          , Gs          , Gd          , Gll^Fmf     , Gd^Fdf      , Gd          , Gd          , Gs          , Gs          , Gs          , Re^Vct      , Gs          , Gs          
Gs          , Gs          , Gs          , Gd          , Gd          , Gd^Fdf      , Gd^Fdf      , Gd^Fdf      , Gd^Fdf      , Gd          , Gs          , Gs          , Gs          , Gs          , Gs          , Gs          , Gs          , Gs          , Gs          , Ww          , Ww          , Ww          , Wwf         , Wwf         , Ww          , Ww          , Ww          , Gs          , Gs          , Gs          , Gs          , Gs          , Gs          , Gd          , Gll^Fmf     , Gd^Fdf      , Gll^Fmf     , Gd          , Gs          , Gs          , Gs          , Gs          , Gs          , Gs          
Gs          , Gs          , Gs          , Gs          , Gd          , Gll^Fmf     , Gll^Fmf     , Gll^Fmf     , Gd          , Gd          , Gs          , Gs          , Gs          , Gs          , Gs          , Gs          , Gs          , Gs          , Gs          , Gs          , Gs          , Gs          , Gd          , Ww          , Ww          , Wo          , Wo          , Ww          , Ww          , Gs          , Gs          , Gs          , Gs          , Gd          , Gd^Fdf      , Gd^Fdf      , Gll^Fmf     , Gd          , Gs          , Gs          , Gs          , Gs          , Gs          , Gs          
Gs          , Gs          , Gs          , Gs          , Gs          , Gd          , Gd          , Gd          , Gd          , Gd          , Gd          , Gs          , Gd          , Gd          , Gd          , Gs          , Gs          , Gs          , Gs          , Gs          , Gs          , Gd          , Gd          , Gd^Fdf      , Gll^Fmf     , Ww          , Ww          , Wo          , Ww          , Gs          , Gs          , Gs          , Gs          , Gd          , Gd          , Gll^Fmf     , Gd          , Gd          , Gs          , Gs          , Gs          , Gs          , Gs          , Gs          
Gs          , Gs          , Gs          , Gs          , Gs          , Gs          , Gs          , Gd          , Gd          , Gd          , Gd          , Gd          , Gll^Fmf     , Gll^Fmf     , Gd^Fdf      , Gd          , Gs          , Gs          , Gs          , Gs          , Gs          , Gd          , Gll^Fmf     , Gd^Fdf      , Gd^Fdf      , Gll^Fmf     , Gd          , Ww          , Wo          , Ww          , Gs          , Gs          , Gs          , Gs          , Gs          , Gd          , Gs          , Gs          , Gs          , Gs          , Gs          , Gs          , Gs          , Gs          
Gs          , Gs          , Gs          , Gs          , Gs          , Gs          , Gs          , Gd          , Gd          , Gll^Fmf     , Gd^Fdf      , Gll^Fmf     , Gd^Fdf      , Gd^Fdf      , Gll^Fmf     , Gd          , Gs          , Re^Vct      , Ce          , Re^Vct      , Gs          , Gd          , Gll^Fmf     , Gd^Fdf      , Gll^Fmf     , Gd^Fdf      , Gd          , Ww          , Ww          , Ww          , Ww          , Gs          , Gs          , Gs          , Gs          , Gs          , Gs          , Gs          , Gs          , Gs          , Gs          , Gs          , Gs          , Gs          
Gs          , Gs          , Gs          , Gs          , Gs          , Gs          , Gs          , Gs          , Gd          , Gll^Fmf     , Gll^Fmf     , Gd^Fdf      , Gd          , Gll^Fmf     , Gd          , Gd          , Gs          , Ce          , 1 Ke        , Ce          , Re^Vct      , Gd          , Gd          , Gll^Fmf     , Gd          , Gd          , Gs          , Gs          , Ww          , Wo          , Wo          , Ww          , Gs          , Gs          , Gs          , Gs          , Gs          , Gs          , Gs          , Gs          , Gs          , Gs          , Gs          , Gs          
Gs          , Gs          , Gs          , Gs          , Gs          , Gs          , Gs          , Gs          , Gs          , Gd          , Gd          , Gd          , Gs          , Gd          , Gs          , Gs          , Gs          , Gs          , Gs          , Ce          , Gs          , Gs          , Gs          , Gd          , Gs          , Gs          , Gs          , Gs          , Gs          , Ww          , Ww          , Ww          , Gs          , Gs          , Gs          , Gs          , Gs          , Gs          , Gs          , Gs          , Gs          , Gs          , Gs          , Gs          
Gs          , Gs          , Gs          , Gs          , Gs          , Gs          , Gs          , Gs          , Gs          , Gs          , Gs          , Gs          , Gs          , Gs          , Gs          , Gs          , Gs          , Gs          , Gs          , Gs          , Gs          , Gs          , Gs          , Gs          , Gs          , Gs          , Gs          , Gs          , Gs          , Ww          , Wo          , Ww          , Gs          , Gs          , Gs          , Gs          , Gs          , Gs          , Gs          , Gs          , Gs          , Gs          , Gs          , Gs          
