border_size=1
usage=map

Xu          , Xu          , Xu          , Xu          , Xu          , Xu          , Xu          , Xu          , Xu          , Xu          , Xu          , Xu          , Xu          , Xu          , Xu          , Xu          , Xu          , Xu          , Xu          , Xu          , Xu          , Xu          , Xu          , Xu          , Xu          , Xu          , Xu          , Xu          , Xu          , Xu          , Xu          , Xu          , Xu          , Xu          
Xu          , Xu          , Xu          , Xu          , Xu          , Xu          , Xu          , Xu          , Xu          , Xu          , Xu          , Xu          , Xu          , Xu          , Xu          , Xu          , Xu          , Xu          , Xu          , Xu          , Xu          , Xu          , Xu          , Xu          , Xu          , Xu          , Xu          , Xu          , Xu          , Xu          , Xu          , Xu          , Xu          , Xu          
Urb         , Xu          , Xu          , Xu          , Xu          , Xu          , Xu          , Xu          , Xu          , Xu          , Xu          , Xu          , Xu          , Xu          , Xu          , Xu          , Xu          , Xu          , Xu          , Xu          , Xu          , Xu          , Xu          , Xu          , Xu          , Xu          , Xu          , Xu          , Xu          , Xu          , Xu          , Xu          , Xu          , Xu          
Uu          , Ur          , Uu          , Uu          , Uu          , Xu          , Ur^Srat     , Xu          , Xu          , Xu          , Uu          , Xu          , Xu          , Xu          , Uu          , Xu          , Xu          , Xu          , Xu          , Xu          , Xu          , Xu          , Xu          , Xu          , Xu          , Xu          , Xu          , Xu          , Xu          , Xu          , Xu          , Xu          , Xu          , Xu          
Uu          , Uu          , Uu          , Uh^Vu       , Rb          , Ur^Srgt     , 3 Ur^Sc     , Ur^Srjt     , Ur          , Uu^Uf       , Uu^Vu       , Uu          , Ur          , Ur          , Uh          , Uu          , Uu          , Xu          , Uu          , Xu          , Xu          , Xu          , Xu          , Xu          , Xu          , Xu          , Xu          , Xu          , Xu          , Xu          , Xu          , Xu          , Xu          , Xu          
Uu          , Uu          , Uu          , Uu^Uf       , Uu          , Ur^Srot     , Ur^Srjl     , Ur^Srst     , Ur          , Uu^Uf       , Rb          , Urb         , Urb         , Ur          , Rb          , Uu          , Uu          , Uu          , Uh          , Urb         , Uu          , Xu          , Uu          , Xu          , Xu          , Xu          , Xu          , Xu          , Xu          , Xu          , Xu          , Xu          , Xu          , Xu          
Ur          , Uu          , Ur          , Urb         , Uh          , Uu          , Uu^Uf       , Uu          , Ur          , Urb         , Ur          , Urb         , Uu^Vu       , Uu          , Uu          , Urb         , Ur          , Uh          , Uu          , Uu^Uf       , Uu          , Uu          , Urb         , Uu^Uf       , Uu          , Xu          , Xu          , Xu          , Xu          , Xu          , Xu          , Xu          , Xu          , Xu          
Ur          , Uu          , Ur          , Uu          , Uu          , Uu          , Ur          , Uu^Vu       , Rb          , Rb          , Uu          , Uu          , Urb         , Uu          , Uu^Uf       , Uu          , Uu^Vu       , Urb         , Uu          , Uu          , Rb          , Ur          , Uu          , Uu          , Ur          , Xu          , Xu          , Xu          , Xu          , Xu          , Xu          , Xu          , Xu          , Xu          
Xu          , Rb          , Uu          , Uu          , Uu^Vu       , Uu          , Uu          , Uu          , Rb          , Ur          , Uu^Vu       , Uu^Uf       , Ur^Srst     , Uh          , Ur^Srot     , Uu          , Rb          , Uu          , Urb         , Uu          , Uu          , Rb          , Uu          , Uu          , Uu          , Uu          , Ur          , Xu          , Xu          , Xu          , Xu          , Xu          , Xu          , Xu          
Xu          , Xu          , Xu          , Uu^Uf       , Ur^Sra      , Uu^Uf       , Urb         , Ur          , Urb         , Uu          , Uu          , Uu          , Ur^Srjt     , 5 Ur^Sc     , Ur^Srat     , Uu          , Ur          , Uu          , Uu          , Uu          , Uu^Uf       , Uu          , Ur          , Uu          , Uu^Vu       , Uu          , Urb         , Xu          , Xu          , Xu          , Xu          , Xu          , Xu          , Xu          
Xu          , Xu          , Xu          , Ur^Srjs     , 4 Ur^Sct    , Ur^Srj      , Uu^Vu       , Uu^Uf       , Rb          , Uu          , Uu          , Cud         , Cud         , Uh          , Ur^Srjl     , Uh          , Ur          , Uu          , Uu          , Uu          , Uu          , Uu          , Rb          , Uu          , Uu^Uf       , Uu          , Uu          , Uu          , Uu          , Xu          , Xu          , Xu          , Xu          , Xu          
Xu          , Xu          , Xu          , Xu          , Xu          , Ur^Srg      , Urb         , Urb         , Rb          , Uu          , Urb         , Uu          , Ur          , Rb          , Uu          , Uu          , Uu          , Uu          , Uu          , Uh          , Uu          , Uu          , Uu^Uf       , Uu          , Uu          , Uu          , Uu^Uf       , Uu          , Uh          , Xu          , Xu          , Xu          , Xu          , Xu          
Xu          , Xu          , Xu          , Xu          , Xu          , Xu          , Xu          , Uu          , Uu          , Uu          , Uu          , Ur          , Uu          , Uu^Vu       , Uu          , Uu          , Uu          , Urb         , Uh          , Urb         , Uu^Uf       , Uu          , Urb         , Uu          , Ur          , Uu          , Uu          , Uu          , Uu          , Uu          , Xu          , Xu          , Xu          , Xu          
Xu          , Xu          , Xu          , Xu          , Xu          , Xu          , Xu          , Urb         , Rb          , Uu          , Uu          , Uu          , Ur          , Ur          , Uu          , Uu^Uf       , Uu          , Ur          , Rb          , Uu          , Uu          , Uh          , Uu          , Ur          , Uh          , Uu          , Uu^Vu       , Uu          , Uu          , Uu          , Xu          , Xu          , Xu          , Xu          
Xu          , Xu          , Xu          , Xu          , Xu          , Xu          , Xu          , Xu          , Uu          , Uh          , Uu          , Uu          , Uu          , Uu^Uf       , Rb          , Urb         , Uu          , Uu          , Urb         , Urb         , Uu^Vu       , Uu          , Uu          , Uu^Uf       , Uu          , Uu          , Uu          , Uu          , Uu          , Urb         , Xu          , Xu          , Xu          , Xu          
Xu          , Xu          , Xu          , Xu          , Xu          , Xu          , Xu          , Xu          , Uu          , Rb          , Uu          , Uu          , Uu          , Uu          , Uu          , Rb          , Uu          , Uu          , Uu          , Uu          , Uu^Uf       , Uu          , Uu          , Uu          , Uu          , Ur          , Urb         , Uu          , Uu          , Urb         , Urb         , Xu          , Xu          , Xu          
Xu          , Xu          , Xu          , Xu          , Xu          , Xu          , Xu          , Xu          , Uu          , Uu          , Uu^Uf       , Ur          , Uu          , Uu          , Uu          , Uu          , Rb          , Uu          , Urb         , Uh          , Uu          , Uu          , Rb          , Rb          , Uu          , Uu          , Uu          , Uu          , Uu          , Uu          , Urb         , Xu          , Xu          , Xu          
Xu          , Xu          , Xu          , Xu          , Xu          , Xu          , Xu          , Xu          , Xu          , Uu          , Uu          , Uu          , Uu          , Uu^Vu       , Uu          , Ur          , Uu          , Uu          , Uu          , Uu^Uf       , Uu          , Uu          , Uu^Vu       , Uu          , Uu          , Urb         , Ur          , Uu          , Uu          , Uh          , Uh          , Xu          , Xu          , Xu          
Xu          , Xu          , Xu          , Xu          , Xu          , Xu          , Xu          , Xu          , Xu          , Xu          , Xu          , Uu          , Uu          , Uu          , Uu          , Uu          , Uu^Uf       , Rb          , Uu          , Uu          , Urb         , Uu          , Uu          , Uu          , Uu          , Uu          , Uu          , Uu          , Uu^Vu       , Uu          , Uu          , Xu          , Xu          , Xu          
Xu          , Xu          , Xu          , Xu          , Xu          , Xu          , Xu          , Xu          , Xu          , Xu          , Xu          , Xu          , Uu          , Rb          , Uu          , Ur          , Urb         , Uu^Uf       , Uh          , Uu          , Ur          , Uu          , Uu          , Ur          , Uh          , Uu          , Urb         , Uu          , Uu          , Uu          , Uu          , Uu          , Xu          , Xu          
Xu          , Xu          , Xu          , Xu          , Xu          , Xu          , Xu          , Xu          , Xu          , Xu          , Xu          , Xu          , Xu          , Uu          , Ur          , Ur          , Urb         , Uu          , Uu          , Uu          , Rb          , Uu          , Uu          , Uu^Uf       , Uu          , Uu          , Uu          , Uu          , Cud         , Uu          , Uu          , Ur          , Xu          , Xu          
Xu          , Xu          , Xu          , Xu          , Xu          , Xu          , Xu          , Xu          , Xu          , Xu          , Xu          , Xu          , Xu          , Xu          , Xu          , Uh          , Uu          , Ur          , Ur          , Uu          , Ce          , Uu^Uf       , Uu^Uf       , Uu^Vu       , Uu          , Uu          , Uu          , Ur          , 2 Kud       , Cud         , Uu^Uf       , Uu          , Uu          , Xu          
Xu          , Xu          , Xu          , Xu          , Xu          , Xu          , Xu          , Xu          , Xu          , Xu          , Xu          , Xu          , Xu          , Xu          , Xu          , Xu          , Xu          , Uu          , Uu^Vu       , Uu          , Ur          , Ce          , 1 Ke        , Uu          , Uu          , Uh          , Uu          , Cud         , Cud         , Cud         , Uu^Vu       , Uu          , Uu          , Uu^Uf       
Xu          , Xu          , Xu          , Xu          , Xu          , Xu          , Xu          , Xu          , Xu          , Xu          , Xu          , Xu          , Xu          , Xu          , Xu          , Xu          , Xu          , Uu          , Rb          , Urb         , Uh          , Ce          , Ce          , Ce          , Uu          , Uu          , Rb          , Uu          , Uu          , Uu          , Ur          , Uu          , Uu          , Ur          
Xu          , Xu          , Xu          , Xu          , Xu          , Xu          , Xu          , Xu          , Xu          , Xu          , Xu          , Xu          , Xu          , Xu          , Xu          , Xu          , Xu          , Xu          , Xu          , Uu          , Rb          , Uu^Uf       , Uh          , Ce          , Uu          , Uu^Vu       , Rb          , Uu^Vu       , Uu          , Uu          , Ur          , Uu          , Uu          , Uu          
Xu          , Xu          , Xu          , Xu          , Xu          , Xu          , Xu          , Xu          , Xu          , Xu          , Xu          , Xu          , Xu          , Xu          , Xu          , Xu          , Xu          , Xu          , Xu          , Uu          , Uu          , Uu          , Uu          , Uu          , Rb          , Urb         , Rb          , Uu          , Uu          , Uu          , Uh          , Uu          , Uh          , Uu^Uf       
