border_size=1
usage=map

Uu          , Uu          , Ur          , Xu          , Xu          , Xu          , Xu          , Xu          , Xu          , Xu          , Rb          , Ur          , Uu          , Uu          , Xu          , Xu          , Xu          , Xu          , Xu          , Xu          , Uu          , Uu          , Xu          , Xu          , Xu          , Xu          , Xu          , Xu          , Xu          , Xu          , Xu          , Xu          , Xu          , Xu          , Xu          , Uu          , Uu          , Xu          , Xu          , Xu          , Xu          , Xu          , Xu          , Ur          , Ur          , Xu          
Xu          , Uu          , Ur          , Rrc^Srat    , 6 Rrc^Sc    , Xu          , Ur          , Xu          , Urb         , Rb          , Ur          , Ur          , Uu^Uf       , Xu          , Xu          , Xu          , Xu          , Xu          , Xu          , Xu          , Ur          , Uu          , Ur          , Xu          , Xu          , Xu          , Xu          , Xu          , Uh          , Uh          , Uh          , Xu          , Uh          , Uh          , Uh          , Uu          , Ur          , Uh          , Uh          , Xu          , Xu          , Xu          , Uh          , Ur          , Rb          , Xu          
Xu          , Xu          , Uh          , Rrc^Srg     , Rrc^Srjt    , Rrc^Sra     , Uu          , Uu          , Ur          , Rb          , Xu          , Uu^Uf       , Xu          , Xu          , Xu          , Xu          , Xu          , Xu          , Xu          , Xu          , Uu^Uf       , Ur          , Rb          , Rb          , Urb         , Urb         , Rb          , Uu^Uf       , Uu^Uf       , Uu^Uf       , Rb          , Xu          , Uu^Uf       , Uu^Uf       , Rb          , Ur          , Ur          , Uu^Uf       , Uh          , Xu          , Xu          , Uh          , Uh          , Rb          , Ur          , Xu          
Xu          , Xu          , Uh          , Uh          , Uu^Uf       , Uu^Uf       , Uu^Uf       , Uu          , Ur          , Uh          , Uu^Uf       , Xu          , Xu          , Xu          , Xu          , Xu          , Xu          , Xu          , Xu          , Xu          , Xu          , Uu^Uf       , Rb          , Re          , Urb         , Rb          , Ur          , Rb          , Ur          , Uu          , Uu          , Rb          , Urb         , Ur          , Urb         , Rb          , Urb         , Uu^Uf       , Uu^Uf       , Xu          , Uu^Uf       , Uu^Uf       , 5 Rrc^Sc    , Rrc^Srg     , Ur          , Xu          
Xu          , Xu          , Xu          , Xu          , Xu          , Xu          , Xu          , Ur          , Re          , Uh          , Uh          , Uu^Uf       , Xu          , Xu          , Xu          , Xu          , Uu^Uf       , Xu          , Xu          , Xu          , Uh          , Uu^Uf       , Ur          , Ur          , Uh          , Uh          , Uh          , Ur          , Rb          , Uu          , Uu^Uf       , Rb          , Ur          , Ur          , Uu^Uf       , Rb          , Ur          , Urb         , Ur          , Xu          , Rb          , Rrc^Srjs    , Rrc^Srst    , Rrc^Srjt    , Uu          , Uu          
Xu          , Xu          , Xu          , Xu          , Uu^Uf       , Uu^Uf       , Uu^Uf       , Re          , Rb          , Rb          , Rb          , Uu^Uf       , Xu          , Xu          , Xu          , Xu          , Uu^Uf       , Uu^Uf       , Xu          , Uh          , Urb         , Rb          , Urb         , Ur          , Uu^Uf       , Uu^Uf       , Xu          , Xu          , Xu          , Uu^Uf       , Uh          , Uu^Uf       , Uh          , Xu          , Uu^Uf       , Uh          , Uh          , Ur          , Uu          , Uu          , Uu          , Rb          , Uu^Uf       , Uu^Uf       , Uu^Uf       , Uu          
Uu          , Xu          , Urb         , Uh          , Uh          , Uh          , Ur          , Urb         , Re          , Ur          , Ur          , Ur          , Uu          , Uh          , Uh          , Uh          , Ur          , Ur          , Ur          , Uh          , Rb          , Rb          , Uu^Uf       , Xu          , Xu          , Uu^Uf       , Xu          , Xu          , Xu          , Xu          , Xu          , Uh          , Xu          , Xu          , Xu          , Uu^Uf       , Xu          , Uh          , Xu          , Ur          , Ur          , Uh          , Uh          , Uh          , Xu          , Xu          
Uu          , Uu          , Rrc^Srst    , Rrc^Srg     , Rrc^Srgt    , Ur          , Urb         , Urb         , Uu^Uf       , Uu^Uf       , Uu^Uf       , Uu          , Uu          , Urb         , Rb          , Rb          , Rr          , Rr          , Rr          , Uu          , Uu          , Uu          , Uu^Uf       , Xu          , Xu          , Xu          , Uh          , Uh          , Uh          , Xu          , Uu          , Xu          , Xu          , Xu          , Xu          , Xu          , Xu          , Xu          , Xu          , Rb          , Ur          , Xu          , Xu          , Xu          , Xu          , Xu          
Xu          , Ur          , Uu^Uf       , 8 Rrc^Sc    , Rrc^Srj     , Ur          , Uh          , Xu          , Xu          , Xu          , Xu          , Xu          , Uu^Uf       , Urb         , Rb          , Uu^Vu       , Rr          , Uu^Vu       , Rrc^Srs     , Rrc^Srjt    , Rrc^Srg     , Rb          , Rb          , Uu^Uf       , Xu          , Xu          , Rb          , Ur          , Rb          , Rb          , Uu          , Uu          , Rb          , Xu          , Uu^Uf       , Uu^Uf       , Uu^Uf       , Xu          , Xu          , Rb          , Rb          , Uu^Uf       , Uu^Uf       , Xu          , Xu          , Xu          
Xu          , Uu^Uf       , Xu          , Uu^Uf       , Xu          , Uh          , Xu          , Xu          , Uu^Uf       , Uh          , Uh          , Xu          , Uh          , Uu^Uf       , Ur          , Urb         , Rb          , Rrc^Srgt    , Rr          , 4 Rrc^Sc    , Rrc^Srat    , Uu^Vu       , Rr          , Ur          , Ur          , Rb          , Urb         , Ur          , Ur          , Rb          , Xu          , Rb          , Rb          , Ur          , Rb          , Uh          , Uh          , Uh          , Ur          , Urb         , Re          , Uu^Uf       , Uh          , Xu          , Xu          , Xu          
Xu          , Xu          , Xu          , Xu          , Uu^Uf       , Xu          , Xu          , Xu          , Uu^Uf       , Uh          , Xu          , Xu          , Uh          , Uu^Uf       , Uu          , Ur          , Rb          , Rb          , Ur          , Uu^Vu       , Rr          , Rr          , Rr          , Uu^Vu       , Ur          , Rb          , Xu          , Uu^Uf       , Uu^Uf       , Uu^Uf       , Xu          , Uh          , Uh          , Ur          , Ur          , Rb          , Urb         , Ur          , Urb         , Urb         , Xu          , Uh          , Xu          , Xu          , Xu          , Xu          
Xu          , Xu          , Rrc^Srgt    , Uu^Uf       , Uh          , Uu^Uf       , Uh          , Uu^Uf       , Rb          , Ur          , Rb          , Uh          , Re          , Uu          , Uu          , Ur          , Xu          , Xu          , Uu^Uf       , Ur          , Rb          , Rr          , Uu          , Uu          , Xu          , Xu          , Uh          , Xu          , Xu          , Xu          , Uu^Uf       , Xu          , Xu          , Xu          , Uh          , Rb          , Urb         , Ur          , Rb          , Uu^Uf       , Uh          , Xu          , Xu          , Xu          , Xu          , Xu          
Urb         , Urb         , Rrc^Srg     , 9 Rrc^Sc    , Rrc^Srst    , Uh          , Urb         , Rb          , Urb         , Ur          , Ur          , Rb          , Re          , Urb         , Uh          , Xu          , Uu^Uf       , Xu          , Xu          , Uu^Uf       , Uh          , Rb          , Uu          , Xu          , Xu          , Uh          , Ur          , Uh          , Rb          , Uu^Uf       , Ur          , Uu^Uf       , Xu          , Xu          , Uh          , Uu^Uf       , Uu^Uf       , Rb          , Uu          , Uu^Uf       , Uh          , Xu          , Xu          , Xu          , Xu          , Xu          
Urb         , Re          , Xu          , Rrc^Srj     , Ur          , Uu          , Uu          , Rb          , Uu^Uf       , Uu^Uf       , Xu          , Rb          , Urb         , Urb         , Uh          , Uu^Uf       , Uu^Uf       , Xu          , Xu          , Uu^Uf       , Uh          , Ur          , Ur          , Ur          , Re          , Rb          , Ur          , Urb         , Rb          , Urb         , Ur          , Ur          , Uu          , Xu          , Xu          , Uh          , Xu          , Rb          , Uu          , Ur          , Ur          , Xu          , Uu^Uf       , Xu          , Xu          , Xu          
Xu          , Xu          , Xu          , Uu^Uf       , Ur          , Uu          , Urb         , Uh          , Uh          , Uu^Uf       , Xu          , Uu^Uf       , Rb          , Rb          , Ur          , Uh          , Xu          , Xu          , Xu          , Uh          , Rb          , Rb          , Urb         , Urb         , Rb          , Rb          , Xos         , Ur          , Xos         , Rb          , Xos         , Uu          , Uu          , Ur          , Xu          , Xu          , Xu          , Uu^Uf       , Uu^Uf       , Uu          , Ur          , Uu^Uf       , Uh          , Xu          , Xu          , Xu          
Xu          , Xu          , Xu          , Uu^Uf       , Uu^Uf       , Ur          , Urb         , Uh          , Xu          , Xu          , Uh          , Uu^Uf       , Uu^Uf       , Rb          , Ur          , Rb          , Xu          , Uh          , Ur          , Urb         , Rb          , Urb         , Xos         , Xos         , Xos         , Xos         , Urb^Xo      , Xos         , Urb^Xo      , Xos         , Urb^Xo      , Xos         , Ur          , Ur          , Uu^Uf       , Xu          , Uh          , Xu          , Uu^Uf       , Rb          , Rb          , Uu^Uf       , Urb         , Uh          , Urb         , Xu          
Xu          , Xu          , Xu          , Xu          , Xu          , Urb         , Urb         , Xu          , Xu          , Xu          , Uh          , Uh          , Xu          , Xu          , Uu          , Ur          , Xu          , Uh          , Ur          , Urb         , Xos         , Xos         , Urb^Xo      , Urb^Xo      , Urb^Xo      , Urb^Xo      , Urb^Xo      , Urb^Xo      , Urb^Xo      , Urb^Xo      , Urb^Xo      , Xos         , Rb          , Rb          , Rb          , Uu^Uf       , Uh          , Uh          , Rb          , Urb         , Rb          , Urb         , Ce          , Urb         , Ce          , Uu          
Xu          , Xu          , Uu^Uf       , Uu^Uf       , Uh          , Ur          , Urb         , Uh          , Xu          , Xu          , Xu          , Xu          , Uh          , Uh          , Uu          , Uu          , Ur          , Rb          , Urb         , Ur          , Xos         , Urb^Xo      , Urb^Xo      , Urb^Xo      , Urb^Xo      , Urb^Xo      , Urb^Xo      , Urb^Xo      , Urb^Xo      , Urb^Xo      , Urb^Xo      , Xos         , Xos         , Urb         , Urb         , Ur          , Ur          , Rb          , Urb         , Urb         , Uu^Uf       , Urb         , Urb         , 1 Ke        , Ce          , Uu          
Xu          , Xu          , Xu          , Uu^Uf       , Uh          , Ur          , Ur          , Uh          , Uh          , Xu          , Ur          , Ur          , Rb          , Uh          , Urb         , Ur          , Rb          , Rb          , Urb         , Xos         , Xos         , Urb^Xo      , Urb^Xo      , Urb^Xo      , Urb^Xo      , Urb^Xo      , Urb^Xo      , Urb^Xo      , Urb^Xo      , Urb^Xo      , Urb^Xo      , Urb^Xo      , Xos         , Rb          , Rb          , Urb         , Ur          , Rb          , Xu          , Xu          , Xu          , Uu^Uf       , Urb         , Ce          , Urb         , Urb         
Xu          , Xu          , Xu          , Uh          , Rb          , Rb          , Re          , Urb         , Rb          , Rb          , Ur          , Rb          , Rb          , Urb         , Re          , Ur          , Uh          , Urb         , Re          , Ur          , Xos         , Urb^Xo      , Urb^Xo      , Urb^Xo      , Urb^Xo      , Urb^Xo      , Urb^Xo      , Urb^Xo      , Urb^Xo      , Urb^Xo      , Urb^Xo      , Urb^Xo      , Xos         , Ur          , Rb          , Uh          , Uh          , Uh          , Xu          , Xu          , Xu          , Uh          , Uh          , Urb         , Xu          , Xu          
Ur          , Xu          , Uu^Uf       , Uu          , Uu          , Rb          , Xu          , Urb         , Urb         , Rb          , Uu^Uf       , Uu^Uf       , Uu^Uf       , Urb         , Xu          , Uh          , Xu          , Uh          , Ur          , Ur          , Uu          , Cud         , Cud         , Urb^Xo      , Urb^Xo      , Urb^Xo      , Urb^Xo      , Urb^Xo      , Urb^Xo      , Urb^Xo      , Urb^Xo      , Xos         , Uu          , Ur          , Ur          , Uu^Uf       , Uu^Uf       , Xu          , Xu          , Xu          , Xu          , Xu          , Xu          , Uh          , Xu          , Xu          
Ur          , Rb          , Rrc^Srgt    , Rrc^Sra     , Uu          , Uu^Uf       , Xu          , Uu^Uf       , Xu          , Xu          , Xu          , Uh          , Uh          , Uh          , Xu          , Xu          , Xu          , Xu          , Uu^Uf       , Uu          , Uu          , Cud         , Xos         , Urb^Xo      , Urb^Xo      , Urb^Xo      , Urb^Xo      , Urb^Xo      , Urb^Xo      , Urb^Xo      , Xos         , Xos         , Uu          , Uu          , Uu^Uf       , Xu          , Xu          , Xu          , Uh          , Uh          , Uh          , Xu          , Xu          , Xu          , Uu^Uf       , Xu          
Xu          , Ur          , Rrc^Sro     , 7 Rrc^Sc    , Rrc^Srg     , Uu^Uf       , Uu^Uf       , Xu          , Uh          , Xu          , Xu          , Xu          , Xu          , Xu          , Xu          , Xu          , Xu          , Xu          , Uu^Uf       , Ur          , Ur          , Ur          , Rb          , Xos         , Xos         , Urb^Xo      , Xos         , Urb^Xo      , Xos         , Xos         , Xos         , Xos         , Ur          , Ur          , Uu^Uf       , Uh          , Uh          , Xu          , Uu^Uf       , Uu^Uf       , Ur          , Uu          , Uu          , Uu^Uf       , Rb          , Ur          
Xu          , Xu          , Xu          , Rrc^Srjt    , Rb          , Rb          , Xu          , Xu          , Uh          , Uh          , Rb          , Xu          , Xu          , Xu          , Uh          , Xu          , Xu          , Xu          , Xu          , Uu^Uf       , Xu          , Rb          , Ur          , Rb          , Urb         , Xos         , Ur          , Xos         , Rb          , Urb         , Urb         , Rb          , Ur          , Rb          , Urb         , Uu^Uf       , Xu          , Xu          , Rb          , Rb          , Ur          , Uu          , Re          , Rb          , Ur          , Ur          
Xu          , Xu          , Xu          , Uh          , Rb          , Ur          , Rb          , Xu          , Urb         , Ur          , Rb          , Urb         , Urb         , Uh          , Uu^Uf       , Uh          , Uu^Uf       , Xu          , Ur          , Xu          , Uh          , Xu          , Uh          , Ur          , Rb          , Urb         , Ur          , Rb          , Rb          , Urb         , Rb          , Rb          , Uu^Uf       , Rb          , Rb          , Urb         , Rb          , Urb         , Rb          , Ur          , Uu^Uf       , Uu^Uf       , Uu^Uf       , Rb          , Xu          , Xu          
Xu          , Xu          , Xu          , Uh          , Uh          , Ur          , Ur          , Rb          , Ur          , Ur          , Xu          , Rb          , Uu          , Uu          , Ur          , Uu^Uf       , Rb          , Rb          , Rb          , Ur          , Rb          , Uh          , Urb         , Ur          , Rb          , Urb         , Uh          , Ur          , Uu^Uf       , Uu^Uf       , Uh          , Uh          , Uu^Uf       , Uu^Uf       , Xu          , Urb         , Rb          , Urb         , Xu          , Xu          , Xu          , Uh          , Uh          , Uh          , Xu          , Xu          
Xu          , Xu          , Xu          , Xu          , Xu          , Xu          , Uu          , Rb          , Uu^Uf       , Uu^Uf       , Xu          , Xu          , Xu          , Uu          , Ur          , Urb         , Urb         , Urb         , Uu^Uf       , Ur          , Urb         , Rb          , Urb         , Rb          , Xu          , Xu          , Xu          , Uh          , Xu          , Uu^Uf       , Xu          , Xu          , Xu          , Xu          , Xu          , Xu          , Ur          , Rb          , Xu          , Xu          , Xu          , Xu          , Xu          , Xu          , Xu          , Xu          
Xu          , Xu          , Xu          , Xu          , Xu          , Uu^Uf       , Uu          , Uu          , Uu^Uf       , Xu          , Uu^Uf       , Uu^Uf       , Uu^Uf       , Ur          , Rb          , Rb          , Xu          , Uu^Uf       , Uh          , Uh          , Uu^Uf       , Rb          , Uu          , Uu^Uf       , Uu^Uf       , Xu          , Xu          , Xu          , Xu          , Xu          , Xu          , Xu          , Xu          , Xu          , Uu^Uf       , Xu          , Ur          , Urb         , Uu^Uf       , Uu^Uf       , Xu          , Xu          , Xu          , Xu          , Xu          , Xu          
Xu          , Xu          , Xu          , Xu          , Uu^Uf       , Uu^Uf       , Rb          , Ur          , Uh          , Xu          , Xu          , Uh          , Rb          , Urb         , Rb          , Urb         , Uu^Uf       , Xu          , Xu          , Uh          , Xu          , Uu          , Uu          , Ur          , Urb         , Xu          , Rb          , Uu^Uf       , Uu^Uf       , Uh          , Uh          , Xu          , Xu          , Uu^Uf       , Uh          , Uu^Uf       , Rb          , Ur          , Uh          , Uu^Uf       , Xu          , Xu          , Xu          , Xu          , Xu          , Xu          
Xu          , Xu          , Xu          , Xu          , Uh          , Rb          , Rrc^Srgt    , Ur          , Xu          , Xu          , Xu          , Uh          , Rb          , Urb         , Uh          , Uu^Uf       , Xu          , Xu          , Xu          , Xu          , Xu          , Xu          , Xu          , Ur          , Ur          , Urb         , Rb          , Urb         , Urb         , Uu^Uf       , Uh          , Xu          , Xu          , Uh          , Urb         , Rb          , Re          , Rb          , Rrc^Srat    , Uh          , Uu^Uf       , Xu          , Xu          , Xu          , Xu          , Xu          
Xu          , Xu          , Xu          , Uh          , Rrc^Srat    , 2 Rrc^Sc    , Rrc^Srot    , Xu          , Xu          , Xu          , Uu^Uf       , Uu^Uf       , Uu          , Rb          , Uh          , Uh          , Xu          , Xu          , Xu          , Xu          , Uu^Uf       , Uu^Uf       , Uh          , Uu^Uf       , Rb          , Urb         , Xu          , Rb          , Urb         , Re          , Uu          , Ur          , Rb          , Urb         , Rb          , Urb         , Uu^Uf       , Re          , 3 Rrc^Sc    , Rrc^Srst    , Uu^Uf       , Uu^Uf       , Xu          , Xu          , Xu          , Xu          
Xu          , Xu          , Xu          , Uh          , Rb          , Rrc^Srst    , Uh          , Uh          , Xu          , Xu          , Uu^Uf       , Uh          , Ur          , Uu          , Uu^Uf       , Xu          , Xu          , Xu          , Xu          , Xu          , Uu^Uf       , Uh          , Uu          , Uu          , Rb          , Rb          , Xu          , Xu          , Uu^Uf       , Uu^Uf       , Uu          , Ur          , Ur          , Rb          , Xu          , Xu          , Xu          , Uu^Uf       , Rrc^Srot    , Rrc^Srgt    , Xu          , Xu          , Xu          , Xu          , Xu          , Xu          
Xu          , Xu          , Ur          , Ur          , Rb          , Urb         , Uh          , Xu          , Xu          , Xu          , Xu          , Uh          , Ur          , Uu          , Uu^Uf       , Xu          , Xu          , Xu          , Xu          , Xu          , Urb         , Ur          , Ur          , Uu          , Uu^Uf       , Uu^Uf       , Xu          , Xu          , Xu          , Uu^Uf       , Uh          , Uh          , Uh          , Xu          , Xu          , Xu          , Xu          , Uu^Uf       , Ur          , Re          , Uh          , Xu          , Xu          , Xu          , Xu          , Xu          
Rb          , Urb         , Ur          , Rb          , Xu          , Xu          , Xu          , Xu          , Xu          , Xu          , Xu          , Uh          , Urb         , Ur          , Urb         , Uu^Uf       , Xu          , Xu          , Xu          , Xu          , Rb          , Ur          , Xu          , Xu          , Xu          , Xu          , Xu          , Xu          , Xu          , Xu          , Xu          , Xu          , Xu          , Xu          , Xu          , Xu          , Xu          , Xu          , Urb         , Urb         , Urb         , Uh          , Xu          , Xu          , Xu          , Xu          
Rb          , Rb          , Xu          , Xu          , Xu          , Xu          , Xu          , Xu          , Xu          , Xu          , Xu          , Xu          , Xu          , Rb          , Rb          , Rb          , Xu          , Xu          , Xu          , Xu          , Rb          , Rb          , Xu          , Xu          , Xu          , Xu          , Xu          , Xu          , Xu          , Xu          , Xu          , Xu          , Xu          , Xu          , Xu          , Xu          , Xu          , Xu          , Xu          , Rb          , Rb          , Rb          , Xu          , Xu          , Xu          , Xu          
