border_size=1
usage=map

Gg          , Gg          , Gg          , Gg          , Gg          , Gg          , Rp          , Gs^Fds      , Gs^Fds      , Gs^Fms      , Gs^Fms      , Gs^Fms      , Gs^Fms      , Gg          , Rp          , Gg          , Gs^Fms      , Gs^Fms      , Gg          , Gg          , Gg          , Gs^Fds      , Gs^Fds      
Gg          , Gg          , Gs^Fds      , Gs^Fds      , Gll^Fp      , Gll^Fp      , Rp          , Gs^Fds      , Gs^Fms      , Gs^Fms      , Gs^Fms      , Gs^Fms      , Gs^Fds      , Gs^Fms      , Rp          , Gs^Fms      , Gll^Fp      , Gll^Fp      , Gll^Fp      , Gg          , Gg          , Gs^Fds      , Gs^Fds      
Gg          , Gg          , Gs^Fds      , Gll^Fp      , Gs^Fds      , Gs^Fms      , Gs^Fms      , Gg          , Rp          , Gs^Fds      , Gs^Fds      , Gs^Fds      , Rp          , Gg          , Gg          , Gg          , Gs^Fds      , Gs^Fds      , Gs^Fds      , Gll^Fp      , Gs^Fms      , Gs^Fds      , Gs^Fms      
Rp          , Gg          , Gll^Fp      , Gll^Fp      , Gs^Fds      , Gs^Fms      , Gll^Fp      , Gll^Fp      , Gs^Fds      , Rp          , Gg          , Rp          , Gll^Fp      , Gll^Fp      , Gll^Fp      , Rp          , Rp          , Gs^Fds      , Gs^Fds      , Gll^Fp      , Gg          , Gs^Fms      , Gg          
Gg          , Rp          , Gll^Fp      , Gs^Fds      , Rp          , Gg          , Gll^Fp      , Gs^Fds      , Gs^Fds      , Gs^Fds      , Gg          , Gg          , Gg          , Gs^Fds      , Gll^Fp      , Gs^Fms      , Gs^Fms      , Gs^Fds      , Gll^Fp      , Gll^Fp      , Gs^Fms      , Gg          , Gg          
Gg          , Gg          , Gs^Fds      , Gll^Fp      , Gs^Fms      , Rp          , Gll^Fp      , Gs^Fms      , Rp          , Gs^Fms      , Rp          , Rp          , Rp          , Gs^Fds      , Gs^Fds      , Gll^Fp      , Gs^Fms      , Rp          , Gll^Fp      , Gs^Fds      , Gs^Fms      , Gs^Fms      , Gg          
Gg          , Gs^Fds      , Gll^Fp      , Gll^Fp      , Gs^Fms      , Gll^Fp      , Gll^Fp      , Rp          , Gs^Fms      , Gg          , Rp          , Gg          , Rp          , Gg          , Gll^Fp      , Gll^Fp      , Gg          , Gs^Fds      , Gs^Fds      , Gs^Fds      , 1 Rp        , Rp          , Gg          
Gg          , Gs^Fds      , Gs^Fds      , Gs^Fms      , Gg          , Gs^Fms      , Gll^Fp      , Gs^Fds      , Gs^Fms      , Gg          , Gg          , Rp          , Gg          , Gg          , Gll^Fp      , Gs^Fms      , Gg          , Rp          , Rp          , Gg          , Gg          , Gg          , Gg          
Gg          , Gg          , Gs^Fms      , Gs^Fms      , Rp          , Gs^Fds      , Rp          , Rp          , Gll^Fp      , Gll^Fp      , Gs^Fds      , Gs^Fms      , Gll^Fp      , Gll^Fp      , Gs^Fms      , Gs^Fms      , Gg          , Gg          , Gg          , Gs^Fds      , Gs^Fds      , Gs^Fms      , Gg          
Gg          , Gg          , Rp          , Gll^Fp      , Gll^Fp      , Gs^Fds      , Gll^Fp      , Gs^Fds      , Gll^Fp      , Gs^Fds      , Gg          , Gs^Fms      , Gs^Fms      , Rp          , Gg          , Gg          , Gs^Fds      , Gll^Fp      , Gs^Fms      , Gs^Fds      , Gs^Fms      , Gs^Fms      , Gg          
Gg          , Rp          , Gg          , Gs^Fms      , Gs^Fms      , Gs^Fds      , Gs^Fds      , Gll^Fp      , Gll^Fp      , Gs^Fds      , Gs^Fds      , Gg          , Gg          , Rp          , Gs^Fds      , Gs^Fds      , Gll^Fp      , Gll^Fp      , Gs^Fms      , Gs^Fds      , Gs^Fds      , Gg          , Gg          
Gg          , Rp          , Gg          , Gs^Fms      , Gs^Fds      , Gs^Fds      , Gs^Fms      , Gs^Fds      , Gs^Fds      , Gll^Fp      , Gll^Fp      , Gs^Fds      , Rp          , Gg          , Gll^Fp      , Gll^Fp      , Gs^Fms      , Gs^Fms      , Gs^Fms      , Gs^Fms      , Gs^Fms      , Gs^Fds      , Gg          
