border_size=1
usage=map

Xu          , Xu          , Xu          , Xu          , Xu          , Xu          , Xu          , Xu          , Xu          , Xu          , Xu          , Xu          , Xu          , Xu          , Xu          , Uh          , Uh          , Uh          , Hh          , Gg          , Gg          , Gg          , Gg          , Gg          , Gg          , Gg          , Gg          , Gg          , Gg          , Gg          , Gg          , Gg          , Gg          , Gg          , Gll^Fp      , Gs^Fms      , Gs^Fms      , Gg          , Gg          , Gll^Fp      , Gll^Fp      , Gll^Fp      , Gll^Fp      , Gs^Fds      , Gll^Fp      , Gll^Fp      , Gll^Fp      , Gll^Fp      , Gll^Fp      , Gll^Fp      , Gll^Fp      , Gll^Fp      , Gll^Fp      , Gll^Fp      , Gll^Fp      , Gs^Fds      , Gll^Fp      , Gs^Fms      
Xu          , Xu          , Xu          , Xu          , Xu          , Xu          , Xu          , Xu          , Xu          , Xu          , Xu          , Xu          , Xu          , Xu          , Xu          , Xu          , Xu          , Uh          , Uh          , Hh          , Gg          , Gg          , Ss          , Gg          , Gg          , Gg          , Ss          , Gg          , Gg          , Gg          , Gg          , Ss          , Ss          , Gg          , Gg          , Gll^Fp      , Gll^Fp      , Gg          , Gg          , Gll^Fp      , Gs^Fms      , Gll^Fp      , Gs^Fds      , Gll^Fp      , Gll^Fp      , Gll^Fp      , Gll^Fp      , Gll^Fp      , Gll^Fp      , Gll^Fp      , Gll^Fp      , Gll^Fp      , Gs^Fds      , Gs^Fds      , Gll^Fp      , Gll^Fp      , Gs^Fds      , Gs^Fds      
Xu          , Xu          , Xu          , Xu          , Xu          , Xu          , Xu          , Xu          , Xu          , Xu          , Xu          , Xu          , Xu          , Xu          , Xu          , Xu          , Xu          , Uh          , Uh          , Hh          , Gg          , Ss          , Ss          , Ss          , Gg          , Ss          , Ss          , Ss          , Ss          , Gg          , Gg          , Ss          , Ss          , Ss          , Gg          , Gg          , Gg          , Gs^Fds      , Gs^Fds      , Gg          , Gll^Fp      , Gs^Fms      , Gll^Fp      , Gll^Fp      , Gll^Fp      , Gll^Fp      , Gll^Fp      , Gs^Fds      , Gll^Fp      , Gll^Fp      , Gll^Fp      , Gll^Fp      , Gs^Fds      , Gs^Fms      , Gll^Fp      , Gs^Fds      , Gll^Fp      , Gll^Fp      
Xu          , Xu          , Xu          , Xu          , Xu          , Xu          , Xu          , Xu          , Xu          , Xu          , Xu          , Xu          , Xu          , Xu          , Uu          , Xu          , Uh          , Xu          , Uh          , Hh          , Hh          , Gg          , Gg          , Gg          , Gg          , Gg          , Gg          , Ss          , Ss          , Ss          , Ss          , Gg          , Gg          , Gg          , Gg          , Gg          , Gs^Fds      , Gg          , Gll^Fp      , Gg          , Gg          , Gll^Fp      , Gs^Fds      , Gll^Fp      , Gll^Fp      , Gll^Fp      , Gll^Fp      , Gll^Fp      , Gll^Fp      , Gll^Fp      , Gll^Fp      , Gll^Fp      , Gll^Fp      , Gll^Fp      , Cv          , Gll^Fp      , Gll^Fp      , Gll^Fp      
Xu          , Xu          , Uu          , Uu          , Rb          , Xu          , Xu          , Xu          , Xu          , Xu          , Xu          , Xu          , Rb          , Uu          , Rb          , Uu          , Uu^Uf       , Uh          , Uh          , Hh          , Hh          , Gg          , Gg          , Gg          , Ss          , Ss          , Ss          , Gg          , Gg          , Gg          , Gg          , Gg          , Gg          , Gg          , Gg          , Gs^Fds      , Gll^Fp      , Gg          , Gg          , Gll^Fp      , Gg          , Gg          , Gll^Fp      , Gll^Fp      , Gll^Fp      , Gs^Fms      , Gll^Fp      , Gll^Fp      , Gs^Fds      , Gll^Fp      , Gll^Fp      , Gll^Fp      , Rrc         , Cv          , Cv          , Gs^Fms      , Gll^Fp      , Gs^Fds      
Uu          , Rb          , Rb          , Uu          , Rb          , Uu          , Uu          , Uu          , Uu^Uf       , Xu          , Uu          , Uu          , Rb          , Rb          , Ur          , Ur          , Ur          , Uu^Uf       , Uh          , Uh          , Hh          , Gg          , Gg          , Gg          , Gg          , Ss          , Gg          , Ss          , Gg          , Gg          , Gg          , Gg          , Ss          , Ss          , Ss          , Gg          , Gg          , Gs^Fds      , Gg          , Gg          , Gll^Fp      , Gll^Fp      , Gll^Fp      , Gll^Fp      , Gll^Fp      , Gll^Fp      , Gll^Fp      , Gll^Fp      , Cv          , Cv          , Rrc         , Rrc         , Cv          , Rrc         , Rrc         , Cv          , Gll^Fp      , Gll^Fp      
Uu^Uf       , Ur          , 1 Ur        , Rb          , Uu          , Ur          , Ur          , Uu^Uf       , Uu^Uf       , Ur          , Rb          , Uu          , Rb          , Uu          , Uu^Uf       , Uu          , Rb          , Rb          , Uu          , Uh          , Uh          , Hh          , Hh          , Gg          , Gg          , Gg          , Gg          , Gg          , Ss          , Gg          , Ss          , Gg          , Gg          , Ss          , Gg          , Gg          , Gg          , Gg          , Gs^Fms      , Gg          , Gll^Fp      , Gs^Fds      , Gll^Fp      , Gll^Fp      , Gll^Fp      , Gs^Fms      , Gll^Fp      , Gll^Fp      , Cv          , Rrc         , Gg          , Cv          , 2 Kv        , Gg^Ve       , Gg^Ve       , Rrc         , Gll^Fp      , Gs^Fds      
Uu^Uf       , Uu          , Uu          , Rb          , Uu          , Uu^Uf       , Ur          , Uu          , Ur          , Ur          , Rb          , Ur          , Ur          , Ur          , Uu          , Uu^Uf       , Ur          , Uu          , Uh          , Uh          , Uh          , Hh          , Hh          , Gg          , Gg          , Gg          , Gg          , Gg          , Ss          , Ss          , Gg          , Gg          , Gg          , Gg          , Gg          , Gg          , Gg          , Gll^Fp      , Gll^Fp      , Gg          , Gg          , Gg          , Gll^Fp      , Gll^Fp      , Gll^Fp      , Gs^Fds      , Gll^Fp      , Gll^Fp      , Gll^Fp      , Rrc         , Gg^Ve       , Gg          , Cv          , Cv          , Rrc         , Rrc         , Gll^Fp      , Gs^Fds      
Uu          , Uu          , Xu          , Xu          , Xu          , Uu          , Xu          , Uu          , Uu          , Rb          , Uu          , Uu          , Uu^Uf       , Uu          , Rb          , Ur          , Rb          , Uu          , Xu          , Xu          , Uh          , Hh          , Hh          , Gg          , Ss          , Ss          , Gg          , Gg          , Gg          , Ss          , Gg          , Gg          , Ss          , Gg          , Gg          , Gg          , Gg          , Gg          , Gg          , Gll^Fp      , Gg          , Gg          , Gs^Fds      , Gll^Fp      , Gll^Fp      , Gll^Fp      , Gs^Fds      , Gll^Fp      , Cv          , Rrc         , Rrc         , Gg          , Rrc         , Rrc         , Gg          , Cv          , Gll^Fp      , Gll^Fp      
Xu          , Xu          , Xu          , Xu          , Xu          , Xu          , Xu          , Xu          , Xu          , Xu          , Xu          , Uu          , Xu          , Uu^Uf       , Uu          , Uu          , Uu          , Rb          , Xu          , Xu          , Uh          , Hh          , Hh          , Gg          , Ss          , Ss          , Ss          , Gg          , Gg          , Gg          , Gg          , Gg          , Ss          , Ss          , Gg          , Gg          , Gll^Fp      , Gg          , Gg          , Gg          , Gg          , Gg          , Gll^Fp      , Gs^Fms      , Gll^Fp      , Gll^Fp      , Gll^Fp      , Gll^Fp      , Cv          , Gg          , Gg          , Rrc         , Gg^Ve       , Gg          , Cv          , Cv          , Gll^Fp      , Gll^Fp      
Xu          , Xu          , Xu          , Xu          , Xu          , Xu          , Xu          , Xu          , Xu          , Xu          , Xu          , Xu          , Xu          , Xu          , Xu          , Xu          , Xu          , Xu          , Xu          , Xu          , Xu          , Uh          , Hh          , Hh          , Gg          , Ss          , Gg          , Gg          , Gg          , Gg          , Ss          , Gg          , Gg          , Gg          , Gg          , Gg          , Gg          , Gll^Fp      , Gll^Fp      , Gg          , Gg          , Gs^Fds      , Gll^Fp      , Gs^Fds      , Gs^Fds      , Gll^Fp      , Gs^Fms      , Gll^Fp      , Gll^Fp      , Cv          , Gs^Fds      , Gll^Fp      , Gs^Fds      , Gll^Fp      , Gll^Fp      , Gll^Fp      , Gll^Fp      , Gs^Fms      
Xu          , Xu          , Xu          , Xu          , Xu          , Xu          , Xu          , Xu          , Xu          , Xu          , Xu          , Xu          , Xu          , Xu          , Xu          , Xu          , Xu          , Xu          , Xu          , Xu          , Xu          , Uh          , Uh          , Hh          , Hh          , Gg          , Gg          , Gg          , Ss          , Ss          , Gg          , Gg          , Ss          , Gg          , Gg          , Gg          , Gg          , Gg          , Gll^Fp      , Gs^Fds      , Gg          , Gll^Fp      , Gll^Fp      , Gs^Fms      , Gll^Fp      , Gll^Fp      , Gll^Fp      , Gs^Fms      , Gll^Fp      , Gll^Fp      , Gll^Fp      , Gll^Fp      , Gll^Fp      , Gs^Fms      , Gll^Fp      , Gll^Fp      , Gs^Fms      , Gll^Fp      
Xu          , Xu          , Xu          , Xu          , Xu          , Xu          , Xu          , Xu          , Xu          , Xu          , Xu          , Xu          , Xu          , Xu          , Xu          , Xu          , Xu          , Xu          , Xu          , Xu          , Xu          , Xu          , Uh          , Uh          , Hh          , Gg          , Ss          , Gg          , Gg          , Ss          , Gg          , Gg          , Ss          , Ss          , Gg          , Gg          , Gll^Fp      , Gg          , Gg          , Gg          , Gg          , Gll^Fp      , Gll^Fp      , Gs^Fds      , Gll^Fp      , Gll^Fp      , Gll^Fp      , Gll^Fp      , Gs^Fms      , Gll^Fp      , Gs^Fms      , Gll^Fp      , Gll^Fp      , Gll^Fp      , Gll^Fp      , Gs^Fds      , Gs^Fms      , Gll^Fp      
Xu          , Xu          , Xu          , Xu          , Xu          , Xu          , Xu          , Xu          , Xu          , Xu          , Xu          , Xu          , Xu          , Xu          , Xu          , Xu          , Xu          , Xu          , Xu          , Xu          , Xu          , Xu          , Xu          , Uh          , Hh          , Hh          , Ss          , Ss          , Gg          , Gg          , Gg          , Gg          , Gg          , Gg          , Gg          , Gg          , Gll^Fp      , Gs^Fds      , Gll^Fp      , Gg          , Gll^Fp      , Gg          , Gg          , Gll^Fp      , Gs^Fms      , Gll^Fp      , Gg          , Gll^Fp      , Gll^Fp      , Gll^Fp      , Gll^Fp      , Gll^Fp      , Gll^Fp      , Gll^Fp      , Gll^Fp      , Gll^Fp      , Gll^Fp      , Gll^Fp      
