border_size=1
usage=map

Uue         , Uue         , Uue         , Uue         , Uue         , Uue         , Xue         , Xue         , Xue         , Xue         , Xue         , Xue         , Xuce        , Xuce        , Xuce        , Xuce        , Uue         , Uue         , Uue         , Xue         , Xue         , Xue         , Uue         , Xue         , Xue         , Uue         , Uue         , Uue         , Uue         , Uue         , Urb         , Urb         
Uue         , Uue         , Uue         , Uue         , Urb         , Uue         , Xue         , Xue         , Uue         , Uue         , Xue         , Xue         , Xue         , Xuce        , Xuce        , Xuce        , Uue^Uf      , Uue         , Uue         , Xue         , Xue         , Uue         , Uue         , Uue         , Xue         , Uue         , Uue         , Uue         , Uue         , Urb         , Urb         , Urb         
Uue         , Uue         , Uue         , Uue         , Urb         , Urb         , Urb         , Xue         , Xue         , Uue         , Xue         , Uue         , Uue         , Xue         , Uue         , Uue         , Uue         , Uue         , Xue         , Xue         , Uue         , Xue         , Xue         , Xue         , Uue         , Uue         , Urb         , Uue         , Urb         , Urb         , Uue         , Uue         
Uue         , Uue         , Urb         , Urb         , Uue         , Uue         , Urb         , Urb         , Uue         , Xue         , Xue         , Uue         , Uue         , Xue         , Xuce        , Xuce        , Xue         , Xue         , Uue         , Uue         , Uue         , Urb         , Urb         , Uue         , Uue         , Urb         , Urb         , Urb         , Urb         , Urb         , Uue         , Uue         
Uue         , Uue         , Uue         , Urb         , Urb         , Uue         , Uue         , Uue         , Uue         , Uue         , Uue         , Xue         , Xue         , Xue         , Uue         , Uue         , Uue         , Uue         , Uue         , Uue         , Uue         , Urb         , Urb         , Uue         , Uue         , Uue         , Urb         , Uue         , Urb         , Uue         , Uue         , Uue         
Uue         , Uue         , Xue         , Uue         , Uue         , Urb         , Urb         , Uue         , Urb         , Urb         , Urb         , Uue         , Uue         , Uue         , Urb         , Urb         , Urb         , Uue^Vct     , Ce          , Uue         , Urb         , Urb         , Uue         , Urb         , Urb         , Urb         , Uue         , Urb         , Urb         , Urb         , Xue         , Uue         
Xue         , Xue         , Xue         , Xue         , Xue         , Uue         , Urb         , Urb         , Uue         , Urb         , Urb         , Ce          , Ke          , Ce          , Uue         , Uue         , Uue         , Ce          , Ke          , Urb         , Urb         , Uue         , Uue         , Urb         , Uue         , Uue         , Uue         , Uue         , Uue         , Xue         , Xue         , Xue         
Xue         , Xue         , Xue         , Xue         , Xue         , Xue         , Xue         , Uue         , Uue         , Uue         , Uue         , Ce          , Uue^Vct     , Ce          , Uue         , 3 Uue       , 1 Uue       , Urb         , Ce          , Ce          , Uue         , Uue         , Urb         , Urb         , Xue         , Xue         , Xue         , Xue         , Xue         , Xue         , Xue         , Xue         
Xue         , Xue         , Xue         , Xue         , Xue         , Xue         , Xue         , Xue         , Xue         , Xue         , Xue         , Uue         , Uue         , Urb         , Urb         , Uue         , Urb         , Urb         , Uue^Vct     , Uue         , Xue         , Xue         , Xue         , Xue         , Xue         , Xue         , Xue         , Xue         , Xue         , Xue         , Xue         , Xue         
Xue         , Xue         , Xue         , Xue         , Xue         , Xue         , Xue         , Xue         , Xos         , Xue         , Xol         , Uue         , Uue         , Uue         , Xol         , Urb         , Xol         , Uue         , Uue         , Uue         , Xol         , Xue         , Xue         , Xue         , Xos         , Xos         , Xos         , Xue         , Xue         , Xue         , Xue         , Xue         
Xue         , Xue         , Xue         , Xue         , Xue         , Xue         , Xol         , Xol         , Urb         , Xol         , Uue         , Uue         , Sm          , Sm          , Sm          , Xol         , Uue         , Sm          , Sm          , Uue         , Uue         , Xol         , Xol         , Xos         , Uue         , Uue         , Uue         , Xos         , Xue         , Xue         , Xue         , Xue         
Xue         , Xue         , Xue         , Xue         , Xue         , Xue         , Xos         , Urb         , Sm          , Uue         , Uue         , Uue         , Uue         , Sm          , Urb         , Uue         , Sm          , Sm          , Urb         , Uue         , Uue         , Urb         , Urb         , Uue         , Sm          , Sm          , Urb         , Xos         , Xue         , Xue         , Xue         , Xue         
Xue         , Xue         , Xue         , Xue         , Xue         , Xue         , Xos         , Urb         , Sm          , Sm          , Sm          , Uue^Vu      , Uue         , Urb         , Urb         , Uue         , Uue         , Sm          , Urb         , Uue         , Sm          , Sm          , Urb         , Uue         , Sm          , Sm          , Urb         , Xos         , Xue         , Xue         , Xue         , Xue         
Xue         , Xue         , Xue         , Xue         , Xue         , Xue         , Xos         , Uue         , Uue         , Urb         , Urb         , Urb         , Sm          , Uue         , Sm          , Uue         , Uue         , Urb         , Uue         , Uue         , Sm          , Sm          , Uue         , Uue         , Uue         , Urb         , Xos         , Xos         , Xue         , Xue         , Xue         , Xue         
Xue         , Xue         , Xue         , Xue         , Xos         , Xos         , Uue         , Uue         , Sm          , Uue         , Uue         , Uue         , Sm          , Sm          , Sm          , Uue         , Uue^Vu      , Uue         , Uue         , Uue         , Uue         , Sm          , Uue         , Uue^Vu      , Uue         , Uue         , Xos         , Xue         , Xue         , Xue         , Xue         , Xue         
Xue         , Xue         , Xue         , Xue         , Xos         , Xos         , Uue         , Sm          , Sm          , Uue         , Uue         , Uue         , Uue         , Urb         , Urb         , Uue         , Uue         , Uue         , Urb         , Uue         , Uue         , Uue         , Urb         , Urb         , Urb         , Uue         , Xos         , Xue         , Xue         , Xue         , Xue         , Xue         
Xue         , Xue         , Xue         , Xue         , Xue         , Xos         , Uue         , Uue^Vu      , Sm          , Sm          , Uue         , Uue         , Uue         , Urb         , Uue         , Uue         , Sm          , Sm          , Sm          , Urb         , Uue         , Uue         , Sm          , Sm          , Sm          , Uue         , Uue         , Xos         , Xue         , Xue         , Xue         , Xue         
Xue         , Xue         , Xue         , Xue         , Xue         , Xos         , Xos         , Uue         , Uue         , Urb         , Sm          , Sm          , Sm          , Uue         , Uue         , Uue         , Uue         , Sm          , Uue         , Urb         , Uue         , Uue         , Sm          , Sm          , Urb         , Uue         , Uue         , Xos         , Xue         , Xue         , Xue         , Xue         
Xue         , Xue         , Xue         , Xue         , Xue         , Xue         , Xue         , Xos         , Xos         , Urb         , Urb         , Sm          , Uue         , Uue         , Urb         , Uue         , Uue         , Uue         , Uue         , Uue         , Uue         , Uue         , Uue         , Urb         , Urb         , Uue^Vu      , Uue         , Xos         , Xue         , Xue         , Xue         , Xue         
Xue         , Xue         , Xue         , Xue         , Xue         , Xue         , Xue         , Xue         , Xos         , Uue         , Uue         , Uue         , Cud         , Uue         , Urb         , Urb         , Cud         , Cud         , Cud         , Uue         , Cud         , Cud         , Cud         , Uue         , Uue         , Uue         , Xos         , Xos         , Xue         , Xue         , Xue         , Xue         
Xue         , Xue         , Xue         , Xue         , Xue         , Xue         , Xue         , Xue         , Xue         , Xos         , Xos         , Cud         , Cud         , Cud         , Cud         , Cud         , Cud         , 2 Kud       , Cud         , Cud         , Cud         , Cud         , Cud         , Uue         , Xos         , Xos         , Xue         , Xue         , Xue         , Xue         , Xue         , Xue         
Xue         , Xue         , Xue         , Xue         , Xue         , Xue         , Xue         , Xue         , Xue         , Xue         , Xos         , Cud         , Cud         , Cud         , Xos         , Xos         , Xos         , Cud         , Xos         , Xos         , Xos         , Cud         , Xos         , Xos         , Xue         , Xue         , Xue         , Xue         , Xue         , Xue         , Xue         , Xue         
Xue         , Xue         , Xue         , Xue         , Xue         , Xue         , Xue         , Xue         , Xue         , Xue         , Xue         , Xos         , Xos         , Xos         , Xue         , Xue         , Xue         , Xos         , Xue         , Xue         , Xue         , Xos         , Xue         , Xue         , Xue         , Xue         , Xue         , Xue         , Xue         , Xue         , Xue         , Xue         
Xue         , Xue         , Xue         , Xue         , Xue         , Xue         , Xue         , Xue         , Xue         , Xue         , Xue         , Xue         , Xue         , Xue         , Xue         , Xue         , Xue         , Xue         , Xue         , Xue         , Xue         , Xue         , Xue         , Xue         , Xue         , Xue         , Xue         , Xue         , Xue         , Xue         , Xue         , Xue         
Xue         , Xue         , Xue         , Xue         , Xue         , Xue         , Xue         , Xue         , Xue         , Xue         , Xue         , Xue         , Xue         , Xue         , Xue         , Xue         , Xue         , Xue         , Xue         , Xue         , Xue         , Xue         , Xue         , Xue         , Xue         , Xue         , Xue         , Xue         , Xue         , Xue         , Xue         , Xue         
