border_size=1
usage=map

Aa          , Aa          , Aa          , Aa          , Aa          , Aa          , Aa          , Aa          , Aa          , Aa          , Aa          , Aa          , Aa          , Aa          , Aa          , Aa          , Aa          , Aa          , Aa          , Aa          , Aa          , Aa          , Aa          , Aa          , Aa          , Aa          , Aa          , Aa          , Aa          , Aa          , Aa          , Aa          , Aa          , Aa          , Aa          , Aa          , Aa          , Aa          , Aa          , Aa          , Aa          , Aa          , Aa          , Aa          , Aa          , Aa          
Ha          , Aa          , Ha          , Aa          , Aa          , Aa          , Aa          , Aa          , Aa          , Aa          , Aa          , Aa          , Aa          , Aa          , Aa          , Aa          , Aa          , Aa          , Ha          , Aa          , Aa          , Aa          , Aa          , Aa          , Aa          , Aa^Fda      , Aa^Fda      , Aa^Fda      , Aa          , Aa          , Aa          , Aa          , Aa^Voa      , Aa          , Ha          , Aa          , Ha          , Aa          , Aa          , Ha          , Ha          , Ha          , Aa          , Aa          , Aa          , Aa          
Ha          , Ha          , Aa          , Aa          , Ha          , Ha          , Ha          , Ha          , Aa          , Aa          , Ha          , Ha          , Ha          , Ha          , Aa          , Aa^Fda      , Aa          , Ha          , Ha          , Aa          , Aa          , Aa          , Aa          , Ha          , Ha          , Aa          , Aa          , Aa          , Ha          , Aa          , Ha          , Aa          , Aa          , Aa          , Ha          , Ha          , Ha          , Aa          , Aa          , Ha          , Aa          , Aa          , Aa          , Aa          , Ha          , Ha          
Aa          , Aa          , Aa          , Aa          , Aa          , Ha          , Aa          , Ha          , Aa          , Aa          , Aa          , Aa          , Aa          , Ha          , Aa          , Aa^Fda      , Aa          , Ha          , Ha          , Ha          , Aa          , Aa          , Aa          , Ha          , Ha          , Ha          , Aa          , Aa          , Aa          , Ha          , Ha          , Ha          , Aa          , Cea         , Cea         , Cea         , Cea         , Aa          , Aa          , Aa          , Aa          , Aa          , Aa          , Ha          , Ha          , Ha          
Aa          , Aa          , Aa          , Aa          , Aa          , Aa          , Aa          , Aa          , Aa^Fda      , Aa^Fda      , Aa^Fda      , Aa          , Aa          , Aa          , Aa          , Aa^Voa      , Aa          , Cea         , 1 Kea       , Cea         , Aa          , Aa^Voa      , Aa          , Aa          , Aa          , Aa          , Aa^Fda      , Aa          , Aa          , Aa          , Aa          , Aa          , Aa          , 8 Kea       , Cea         , Cea         , Aa          , Aa          , Aa          , Aa^Voa      , Aa          , Aa          , Ha          , Ha          , Ms^Xm       , Ms          
Aa          , Aa          , Aa          , Aa          , Aa          , Aa          , Aa          , Aa          , Aa          , Aa^Fda      , Aa          , Aa          , Aa          , Aa          , Aa          , Aa          , Aa          , Cea         , Cea         , Cea         , Aa          , Aa^Fda      , Aa^Fda      , Aa          , Aa          , Aa          , Aa^Fda      , Aa^Fda      , Aa^Fda      , Aa          , Aa          , Aa^Voa      , Aa          , Aa          , Aa          , Aa          , Ha          , Aa          , Ha          , Aa          , Ha          , Ha          , Ha          , Ms          , Ms          , Ms          
Ha          , Ha          , Ha          , Ha          , Ha          , Aa          , Aa          , Aa          , Aa          , Aa          , Aa          , Aa          , Ha          , Ha          , Ha          , Aa          , Aa          , Aa          , Aa          , Aa          , Aa^Voa      , Aa^Fda      , Aa          , Aa^Fda      , Aa          , Aa          , Aa          , Aa^Fda      , Aa          , Aa          , Aa          , Aa          , Aa          , Aa          , Ha          , Ha          , Ha          , Ha          , Ha          , Ha          , Ha          , Ha          , Ms          , Ms          , Ms          , Ms          
Ha          , Ha          , Ha          , Ha          , Ha          , Ha          , Ha          , Aa          , Ha          , Ha          , Ha          , Ha          , Ha          , Ha          , Ha          , Ha          , Ha          , Aa          , Aa          , Aa          , Aa          , Aa          , Aa          , Aa          , Ha          , Aa          , Ha          , Aa          , Aa          , Aa          , Aa          , Aa          , Ha          , Ha          , Ha          , Ha          , Ms          , Ha          , Ms          , Ha          , Ms^Xm       , Ms          , Ms^Xm       , Ms^Xm       , Ms          , Ms          
Ms          , Ha          , Ms          , Ha          , Ms          , Ha          , Ha          , Ha          , Ha          , Ha          , Ha          , Ha          , Ms          , Ms          , Ms^Xm       , Ha          , Ha          , Ha          , Ha          , Aa          , Aa          , Aa          , Ha          , Aa          , Aa          , Ha          , Aa          , Ha          , Aa          , Aa          , Ha          , Ha          , Ha          , Ha          , Ms^Xm       , Ms          , Ms^Xm       , Ms          , Ms^Xm       , Ms^Xm       , Ms          , Ms^Xm       , Ms          , Ms^Xm       , Ms^Xm       , Ms          
Ms          , Ms          , Ms          , Ms          , Ms^Xm       , Ms          , Ms          , Ms          , Ms          , Ms          , Ms          , Ms          , Ms^Xm       , Ms          , Ms          , Ms          , Ms          , Ha          , Ha          , Ha          , Ha          , Aa          , Ha          , Aa          , Ha          , Aa          , Ha          , Aa          , Aa          , Ha          , Ha          , Ha          , Ms^Xm       , Ms          , Ms^Xm       , Ms          , Ms          , Ms^Xm       , Ms          , Ms          , Ms^Xm       , Ms          , Ms          , Ms          , Ms          , Ms          
Ms          , Ms          , Ms          , Ms          , Ms          , Ms          , Ms^Xm       , Ms          , Ms          , Ms^Xm       , Ms          , Ms          , Ms          , Ms          , Ms^Xm       , Ms          , Ms          , Ha          , Ha          , Ha          , Ha          , Aa          , Ha          , Aa          , Ha^Fda      , Ha^Fda      , Aa^Fda      , Aa          , Ha          , Ha          , Ha          , Ms          , Ms^Xm       , Ms^Xm       , Ms          , Ms          , Ms^Xm       , Ms          , Ms          , Ms          , Ms          , Ms          , Ms          , Ms^Xm       , Ms          , Ms          
Ms          , Ms          , Ms          , Ms^Xm       , Ms^Xm       , Ms^Xm       , Xu          , Ms^Xm       , Ms^Xm       , Ms          , Ms^Voa      , Ms          , Ms^Xm       , Ms          , Ms          , Ms          , Ms          , Ms^Xm       , Ms          , Ha          , Ha          , Aa          , Aa          , Aa          , Aa          , Ha^Fda      , Aa^Fda      , Aa^Fda      , Aa          , Ha          , Ha          , Ms          , Ms^Xm       , Ms          , Ms          , Ms          , Ms          , Ms          , Ms          , Ms          , Ms          , Ms          , Ms          , Ms          , Ms          , Ms          
Ms          , Ms          , Ms          , Ms          , Ms^Xm       , Xu          , Uu          , Xu          , Cea         , Ms          , Ms          , Ms          , Ms^Voa      , Ms          , Ms          , Ms          , Ms          , Ms^Xm       , Ms^Xm       , Ms          , Ms          , Ha          , Aa          , Ha          , Ha^Fda      , Aa^Fda      , Ha^Fda      , Ha          , Aa          , Ha          , Ha          , Ms          , Ms^Xm       , Ms          , Ms          , Ms          , Ms^Xm       , Ms          , Ms          , Ms          , Ms          , Ms^Xm       , Ms          , Ms          , Ms          , Ms          
Ms          , Ms^Xm       , Ms          , Ms          , Ms^Xm       , Xu          , Xu          , Ur          , 9 Kea       , Cea         , Ms          , Ms          , Ms          , Ms          , Ms          , Ms^Xm       , Ms          , Ms          , Ms^Xm       , Ms          , Ms          , Ha          , Ha          , Ha^Fda      , Ha^Fda      , Aa^Fda      , Aa^Fda      , Ha^Fda      , Aa          , Ha          , Ha          , Ms          , Ms          , Ms^Xm       , Ms^Xm       , Ms^Xm       , Ms          , Ms^Xm       , Ms^Xm       , Ms          , Ms          , Ms          , Ms          , Ms          , Ms          , Ms          
Ms          , Ms          , Ms^Xm       , Ms          , Ms          , Ms^Xm       , Ms^Xm       , Cea         , Cea         , Cea         , Ms          , Ms          , Ms          , Ms          , Ms          , Ms          , Ms          , Ms          , Ms^Xm       , Ms          , Ms          , Ha          , Ha          , Aa          , Aa^Fda      , Aa^Fda      , Ha          , Aa          , Aa          , Aa          , Ha          , Ha          , Ha          , Ms          , Ms          , Ms          , Ms          , Ms          , Ms          , Ms^Xm       , Ms^Xm       , Ms          , Ms          , Ms^Xm       , Ms          , Ms          
Ms          , Ms          , Ms          , Ms          , Ms          , Ms          , Ms^Xm       , Ms          , Ms          , Ms          , Ms          , Ms^Voa      , Ms          , Ms          , Ms          , Ms          , Ms^Xm       , Ms^Xm       , Ms          , Ms          , Ha          , Ha          , Ha          , Aa          , Ha          , Ha          , Ha          , Ha          , Aa          , Aa          , Aa          , Ha          , Ha          , Ha          , Ha          , Ms          , Ha          , Ha          , Ms          , Ms^Xm       , Ms          , Ms^Xm       , Ms^Xm       , Ms          , Ms          , Ms          
Ms          , Ms          , Ms          , Ms          , Ha          , Ms          , Ms          , Ms          , Ms          , Ms          , Ms          , Ms          , Ms          , Ms          , Ms          , Ms^Xm       , Ms          , Ms          , Ha          , Ha          , Ha          , Ha          , Aa          , Aa          , Aa          , Ha          , Ha          , Aa          , Ha          , Ha          , Ha          , Aa          , Ha          , Ha          , Ha          , Ha          , Ha          , Ha          , Ha          , Ms          , Ha          , Ms          , Ms          , Ms^Xm       , Ms^Xm       , Ms          
Ms          , Ms          , Ha          , Ha          , Ha          , Ha          , Ha          , Ms          , Ms          , Ms          , Ha          , Ms          , Ha          , Ms          , Ha          , Ms          , Ha^Fda      , Ha          , Ha          , Ha          , Ha          , Aa          , Ha          , Ha          , Aa          , Aa^Voa      , Aa          , Aa          , Ha          , Ha^Voa      , Ha          , Aa          , Aa          , Ha          , Ha          , Ha          , Ha          , Ha          , Ha          , Ha          , Ha          , Ha          , Ms          , Ms          , Ms          , Ms          
Ha          , Ha          , Ha          , Ha^Voa      , Ha          , Ha          , Ha          , Ha          , Ha^Fda      , Ha^Fda      , Ha          , Ha          , Ha          , Ha          , Ha          , Ha^Fda      , Ha^Fda      , Ha^Fda      , Aa          , Ha          , Aa          , Aa          , Aa          , Aa          , Ha          , Aa          , Aa          , Aa          , Aa          , Aa          , Aa          , Aa          , Ha          , Aa          , Aa^Voa      , Aa          , Aa          , Ha          , Ha^Fda      , Ha^Fda      , Ha^Fda      , Ha^Fda      , Ha^Fda      , Ms          , Ms          , Ms          
Ha          , Ha          , Aa          , Aa          , Aa          , Ha          , Aa          , Ha^Fda      , Aa^Fda      , Ha^Fda      , Aa          , Aa          , Aa          , Ha          , Aa          , Ha          , Aa^Fda      , Aa^Fda      , Aa^Fda      , Aa          , Aa          , Aa          , Coa         , Coa         , Coa         , Ha          , Aa          , Aa          , Aa          , Ha          , Coa         , Coa         , Coa         , Ha          , Aa          , Aa          , Ha^Fda      , Aa^Fda      , Aa^Fda      , Ha^Fda      , Ha^Fda      , Ha^Voa      , Ha^Fda      , Ha          , Ha          , Ha          
Aa          , Aa          , Aa          , Aa          , Aa          , Aa          , Aa^Fda      , Aa^Fda      , Aa^Fda      , Aa^Fda      , Aa          , Aa          , Aa          , Aa          , Ha          , Aa^Fda      , Aa^Fda      , Aa^Fda      , Ha^Fda      , Ha^Fda      , Aa          , Ha          , Coa         , 2 Koa       , Coa         , Ha          , Aa^Voa      , Ha          , Aa          , Ha          , Coa         , 3 Koa       , Coa         , Ha          , Aa          , Ha          , Ha          , Ha^Fda      , Aa^Fda      , Ha^Fda      , Ha          , Ha          , Ha          , Ha          , Ha          , Ha          
Aa          , Aa          , Ha          , Aa          , Ha          , Ha^Fda      , Aa^Fda      , Aa^Fda      , Aa^Fda      , Aa^Fda      , Ha          , Ha          , Aa          , Ha          , Ha^Voa      , Ha          , Aa          , Ha^Fda      , Ha^Fda      , Ha^Fda      , Aa          , Ha          , Ha          , Coa         , Ha          , Aa          , Aa          , Ha          , Aa          , Ha          , Ha          , Coa         , Aa          , Aa          , Ha          , Aa^Voa      , Aa          , Aa          , Aa          , Aa          , Aa          , Ha          , Aa          , Ha          , Aa          , Ha          
Ha          , Ha          , Ha^Voa      , Aa          , Aa          , Ha^Fda      , Ha^Fda      , Ha^Fda      , Ha          , Aa          , Ha          , Ha          , Ha          , Aa          , Aa          , Aa          , Ha          , Aa          , Aa          , Aa          , Aa          , Aa^Voa      , Aa          , Aa          , Ha          , Ha          , Aa          , Aa          , Aa^Voa      , Aa          , Aa          , Aa          , Aa          , Ha          , Ha          , Ha          , Aa          , Ha          , Ha          , Aa          , Aa          , Aa          , Ha^Voa      , Aa          , Aa          , Aa          
Ha          , Ha          , Ha          , Ha          , Aa          , Aa          , Ha          , Ha          , Ha^Voa      , Aa          , Aa          , Ha          , Ha          , Aa          , Ha          , Ha          , Ha          , Aa          , Ha          , Ha          , Ha          , Aa          , Ha          , Aa          , Aa          , Aa          , Ha          , Ha          , Ha          , Aa          , Ha          , Ha          , Ha          , Aa          , Aa          , Aa          , Aa          , Ha          , Ha          , Aa          , Aa          , Aa          , Ha          , Ha          , Aa          , Aa          
Aa          , Aa          , Aa          , Aa          , Ha          , Aa          , Aa          , Ha          , Aa          , Aa          , Ha          , Aa          , Aa          , Aa          , Aa          , Ha          , Ha^Voa      , Aa          , Aa          , Ha          , Aa          , Aa          , Ha          , Ha          , Aa          , Aa          , Ha          , Ha          , Aa          , Aa          , Aa          , Ha          , Aa          , Aa          , Ha          , Ha          , Aa          , Aa          , Aa          , Aa          , Ha          , Aa          , Aa          , Ha          , Aa          , Ha          
Aa          , Aa          , Ha          , Ha          , Ha          , Ha          , Aa          , Aa          , Aa          , Ha          , Ha          , Ha          , Aa          , Aa          , Aa          , Aa          , Aa          , Aa          , Aa          , Aa          , Aa          , Aa          , Aa          , Ha          , Aa          , Aa          , Aa          , Ha          , Aa          , Aa          , Aa          , Aa          , Aa          , Aa          , Aa          , Ha          , Aa          , Aa          , Aa          , Ha          , Ha          , Ha          , Aa          , Aa          , Ha          , Ha          
