border_size=1
usage=map

Hh          , Hh          , Gg          , Gg          , Gg          , Gg          , Gg          , Gg          , Gg          , Gg          , Gg          , Gg          , Gg          , Hh          , Mm          , Mm          , Mm          , Mm          , Mm^Xm       , Mm          , Mm          , Mm          , Mm          , Mm          , Mm          , Mm          , Mm^Xm       , Mm          , Mm          , Mm          , Mm          , Mm          , Mm          , Mm          , Mm          
Gg          , Hh          , Gg          , Gg          , Gg          , Gg          , Gg          , Gg          , Hh          , Gg          , Gg          , Gg          , Gg          , Hh          , Mm          , Mm          , Mm          , Mm          , Mm          , Mm^Xm       , Mm^Xm       , Mm          , Mm          , Mm          , Mm^Xm       , Mm          , Mm          , Mm          , Hh          , Mm          , Mm          , Mm          , Mm^Xm       , Mm          , Mm          
Gg          , Gg          , Hh          , Gg          , Gg          , Gg          , Gg          , Hh          , Mm          , Hh          , Hh          , Gg          , Gg          , Hh          , Hh          , Mm^Vo       , Hh          , Mm          , Mm^Xm       , Mm          , Mm^Vo       , Mm          , Mm^Xm       , Mm^Xm       , Mm          , Mm          , Mm          , Hh          , Co          , Hh          , Mm          , Mm          , Mm          , Mm          , Mm          
Gg          , Hh          , Co          , Co          , Co          , Hh          , Gg          , Mm          , Mm          , Mm          , Mm^Vo       , Gg          , Gg          , Gg          , Gg          , Gg          , Hh          , Mm          , Mm          , Mm^Xm       , Mm^Xm       , Mm          , Mm          , Mm          , Mm          , Mm^Vo       , Hh          , Co          , 4 Ke        , Co          , Mm          , Mm          , Mm^Vo       , Mm          , Mm          
Gg          , Hh          , Co          , 5 Ke        , Co          , Hh          , Gg          , Mm          , Hh          , Mm          , Mm          , Mm          , Mm          , Gg          , Gg          , Gg          , Gg          , Hh          , Gg          , Mm          , Mm          , Mm          , Mm^Xm       , Mm^Xm       , Mm          , Mm          , Hh          , Co          , Co          , Co          , Mm          , Mm          , Mm^Xm       , Mm          , Mm          
Gg          , Gg          , Hh          , Co          , Hh          , Gg          , Gg          , Hh          , Mm^Xm       , Mm^Xm       , Mm          , Mm          , Mm          , Hh          , Hh          , Gg          , Hh          , Gg          , Gg          , Hh          , Mm          , Mm^Xm       , Mm          , Mm          , Hh          , Mm          , Mm          , Hh          , Hh          , Mm          , Mm^Xm       , Mm^Xm       , Mm          , Mm          , Mm          
Gg          , Gg          , Gg          , Hh          , Gg          , Gg          , Mm          , Mm^Xm       , Mm          , Mm          , Co          , Co          , Mm          , Mm          , Mm          , Gg          , Gg          , Hh          , Gg          , Hh          , Hh          , Mm          , Gg          , Hh          , Gg          , Gg          , Hh          , Mm^Vo       , Mm          , Mm          , Mm          , Mm          , Mm          , Mm^Xm       , Mm          
Gg          , Gg          , Gg          , Gg          , Gg          , Gg          , Hh          , Mm          , Hh          , Mm          , Mm          , Co          , Mm^Vo       , Mm          , Mm          , Hh          , Gg          , Gg          , Gg          , Gg          , Gg          , Gg          , Hh          , Gg          , Hh          , Gg          , Gg          , Hh          , Gg          , Mm          , Mm          , Hh          , Hh          , Mm          , Hh          
Gg          , Hh          , Gg          , Gg          , Gg          , Gg          , Gg          , Hh          , Gg          , Hh          , Mm          , Mm          , Mm          , Mm          , Hh          , Hh          , Gg          , Hh          , Hh          , Gg          , Gg          , Gg          , Gg          , Hh          , Hh          , Gg          , Gg          , Gg          , Gg          , Gg          , Gg          , Mm          , Hh          , Gg          , Gg          
Hh          , Hh          , Mm          , Mm          , Mm          , Gg          , Gg          , Gg          , Gg          , Gg          , Gg          , Mm          , Gg          , Gg          , Gg          , Gg          , Mm          , Hh          , Mm          , Gg          , Hh          , Gg          , Gg          , Hh          , Hh          , Hh          , Gg          , Gg          , Gg          , Hh          , Hh          , Gg          , Gg          , Gg          , Gg          
Hh          , Hh          , Mm          , Mm^Vo       , Mm          , Mm          , Mm          , Gg          , Gg          , Gg          , Hh          , Gg          , Gg          , Gg          , Hh          , Mm          , Mm^Xm       , Mm          , Mm          , Mm          , Mm^Vo       , Hh          , Gg          , Gg          , Gg          , Gg          , Mm          , Mm^Xm       , Mm^Xm       , Gg          , Gg          , Gg          , Hh          , Hh          , Hh          
Mm          , Mm^Xm       , Mm^Xm       , Mm          , Mm          , Mm          , Mm          , Mm          , Hh          , Gg          , Hh          , Hh          , Gg          , Hh          , Mm          , Mm          , Mm          , Mm^Xm       , Mm^Xm       , Mm          , Mm          , Hh          , Hh          , Gg          , Gg          , Hh          , Mm          , Mm          , Mm          , Mm^Xm       , Mm          , Gg          , Gg          , Hh          , Hh          
Mm          , Mm          , Co          , Mm^Xm       , Mm          , Mm          , Mm          , Mm          , Hh          , Gg          , Gg          , Hh          , Gg          , Hh          , Mm          , Mm          , Mm          , Mm^Vo       , Mm          , Mm          , Mm          , Mm^Xm       , Mm          , Gg          , Gg          , Hh          , Hh          , Mm          , Mm^Vo       , Mm          , Hh          , Hh          , Hh          , Gg          , Gg          
Mm          , Mm          , Co          , Co          , Hh          , Hh          , Mm          , Hh          , Hh          , Gg          , Gg          , Gg          , Gg          , Gg          , Mm          , Mm^Xm       , Mm^Xm       , Mm          , Co          , Mm^Xm       , Mm          , Mm          , Mm          , Gg          , Gg          , Gg          , Mm          , Mm^Xm       , Mm^Xm       , Co          , Co          , Mm^Xm       , Mm          , Gg          , Gg          
Mm          , Mm          , Mm^Xm       , Mm          , Mm^Vo       , Hh          , Mm          , Hh          , Gg          , Gg          , Hh          , Hh          , Hh          , Gg          , Gg          , Mm          , Mm          , Mm^Xm       , Co          , Co          , Mm^Xm       , Mm^Xm       , Mm          , Hh          , Gg          , Gg          , Gg          , Mm          , Mm          , Mm^Xm       , Co          , Mm          , Gg          , Gg          , Gg          
Mm          , Mm          , Mm          , Mm^Xm       , Mm^Xm       , Mm          , Hh          , Mm          , Gg          , Gg          , Gg          , Hh          , Hh          , Gg          , Gg          , Hh          , Hh          , Mm          , Mm          , Mm^Xm       , Mm          , Mm          , Hh          , Hh          , Gg          , Gg          , Gg          , Gg          , Hh          , Mm          , Hh          , Hh          , Gg          , Hh          , Hh          
Mm          , Mm          , Hh          , Mm          , Mm          , Mm          , Hh          , Gg          , Hh          , Hh          , Gg          , Co          , 6 Ke        , Co          , Gg          , Gg          , Hh          , Mm^Vo       , Mm          , Mm          , Gg          , Gg          , Gg          , Gg          , Hh          , Hh          , Hh          , Gg          , Gg          , Hh          , Gg          , Gg          , Gg          , Hh          , Hh          
Mm          , Mm^Vo       , Mm          , Hh          , Gg          , Hh          , Gg          , Gg          , Gg          , Gg          , Mm^Xm       , Co          , Co          , Co          , Hh          , Gg          , Gg          , Hh          , Gg          , Gg          , Hh          , Gg          , Gg          , Gg          , Gg          , Hh          , Hh          , Gg          , Gg          , Gg          , Mm          , Mm          , Mm          , Gg          , Gg          
Mm          , Mm          , Mm^Xm       , Mm          , Gg          , Gg          , Gg          , Gg          , Mm^Xm       , Mm^Xm       , Mm          , Mm          , Gg          , Hh          , Hh          , Hh          , Gg          , Gg          , Hh          , Hh          , Hh          , Gg          , Gg          , Gg          , Gg          , Gg          , Gg          , Gg          , Mm          , Mm          , Mm          , Mm          , Mm          , Mm^Xm       , Mm          
Gg          , Mm          , Mm          , Mm          , Gg          , Hh          , Gg          , Mm          , Mm          , Mm^Vo       , Mm^Xm       , Mm          , Mm          , Gg          , Gg          , Hh          , Gg          , Hh          , Hh          , Hh          , Gg          , Gg          , Mm          , Mm          , Mm          , Mm^Xm       , Mm^Xm       , Mm          , Mm          , Mm^Vo       , Mm          , Mm^Xm       , Mm^Xm       , Mm          , Mm          
Gg          , Hh          , Hh          , Hh          , Gg          , Hh          , Gg          , Mm          , Mm          , Mm          , Co          , Mm^Xm       , Mm^Xm       , Hh          , Hh          , Gg          , Hh          , Gg          , Gg          , Gg          , Hh          , Hh          , Mm          , Mm          , Mm          , Mm^Xm       , Mm          , Mm^Xm       , Mm          , Mm          , Co          , Co          , Mm          , Mm^Xm       , Mm          
Gg          , Gg          , Gg          , Gg          , Hh          , Hh          , Gg          , Mm          , Mm          , Co          , Co          , Mm          , Mm^Vo       , Mm          , Hh          , Gg          , Hh          , Gg          , Mm          , Mm          , Mm          , Hh          , Mm          , Mm          , Mm          , Mm          , Mm          , Mm          , Mm          , Mm^Xm       , Mm^Xm       , Co          , Mm^Vo       , Mm          , Mm          
Hh          , Hh          , Hh          , Gg          , Gg          , Hh          , Gg          , Mm          , Hh          , Mm          , Hh          , Mm          , Mm          , Mm          , Mm          , Gg          , Gg          , Gg          , Mm^Xm       , Mm^Xm       , Mm          , Mm          , Co          , Co          , Gg          , Mm          , Co          , Mm          , Co          , Mm          , Mm          , Mm          , Mm          , Mm          , Mm          
Hh          , Hh          , Co          , Co          , Co          , Gg          , Gg          , Gg          , Gg          , Hh          , Mm          , Mm^Xm       , Mm          , Mm          , Gg          , Gg          , Gg          , Mm          , Mm^Xm       , Mm          , Hh          , Co          , Rb          , Gg          , Hh          , Gg          , Gg^Vo       , Rb          , Hh          , Co          , Mm          , Mm          , Mm          , Mm          , Mm          
Gg          , Hh          , Co          , 3 Ko        , Co          , Gg          , Gg          , Hh          , Hh          , Gg          , Gg          , Mm          , Gg          , Gg          , Hh          , Gg          , Gg          , Mm          , Mm          , Mm          , Mm          , Co          , Gg^Vo       , Rb          , Hh          , Hh          , Rb          , Rb          , Hh          , Hh          , Co          , Mm          , Mm          , Mm^Xm       , Mm          
Gg          , Gg          , Hh          , Co          , Hh          , Hh          , Gg          , Gg          , Gg          , Hh          , Gg          , Gg          , Hh          , Hh          , Hh          , Gg          , Gg          , Mm          , Hh          , Mm          , Co          , Gg          , Gg          , Rb          , Rb          , Rb          , Rb          , Gg          , Gg^Vo       , Gg          , Rb          , Co          , Mm          , Mm          , Mm          
Mm          , Gg          , Gg          , Hh          , Gg          , Gg          , Mm          , Hh          , Hh          , Gg          , Hh          , Gg          , Gg          , Hh          , Hh          , Gg          , Hh          , Mm          , Mm          , Hh          , Rb          , Gg          , Gg^Vo       , Rb          , Co          , Co          , Co          , Rb          , Rb          , Rb          , Rb          , Gg^Vo       , Mm          , Mm          , Mm          
Mm          , Mm^Vo       , Mm          , Gg          , Mm          , Mm          , Mm^Xm       , Mm          , Mm          , Hh          , Co          , Gg          , Gg          , Hh          , Hh          , Gg          , Hh          , Hh          , Mm          , Mm          , Co          , Rb          , Rb          , Rb          , Co          , Ko          , Co          , Rb          , Hh          , Gg          , Co          , Co          , Mm          , Mm          , Mm          
Mm          , Mm          , Mm^Xm       , Mm          , Mm          , Mm^Xm       , Mm          , Mm^Xm       , Mm^Xm       , Mm          , Co          , Co          , Gg          , Gg          , Gg          , Gg          , Mm          , Mm          , Mm^Xm       , Mm          , Co          , Gg          , Hh          , Rb          , Rb          , Co          , Rb          , 1 Rb        , Hh          , Hh          , Co          , Mm          , Mm          , Mm          , Mm          
Mm          , Mm          , Mm          , Mm^Xm       , Mm^Xm       , Mm^Xm       , Mm          , 8 Mm        , Mm          , Mm^Xm       , Mm^Xm       , Mm^Xm       , Mm          , Hh          , Hh          , Gg          , Mm          , Mm^Xm       , Mm^Xm       , Mm          , Mm          , Co          , Gg          , Hh          , Gg^Vo       , Rb          , 7 Gg        , Ko          , Rb          , Co          , Mm          , Mm          , Mm^Xm       , Mm^Xm       , Mm          
Mm          , Mm          , Mm^Vo       , Mm          , Mm          , Mm^Xm       , Mm          , Mm          , Mm^Vo       , Mm          , Mm          , Mm^Xm       , Mm          , Mm^Xm       , Mm^Xm       , Mm          , Mm          , Mm          , Mm          , Mm^Xm       , Mm          , Mm          , Mm          , Gg          , Co          , Gg          , Co          , Rb          , Mm          , Mm          , Mm          , Mm^Xm       , Mm^Vo       , Mm          , Mm          
Mm          , Mm          , Mm          , Mm          , Mm          , Mm^Xm       , Mm^Xm       , Mm          , Mm          , Mm          , 9 Mm        , Mm^Xm       , Mm          , Mm          , Mm          , Mm^Xm       , Mm          , Mm          , Co          , Co          , Mm          , Mm^Xm       , Mm^Xm       , Mm          , Mm          , Co          , Mm          , Mm          , Mm          , Mm^Xm       , Mm^Xm       , Mm          , Mm          , Mm^Xm       , Mm          
Mm          , Mm          , Mm^Xm       , Mm^Xm       , Mm          , Mm          , Mm^Xm       , Mm          , Mm          , Mm          , Mm^Xm       , Mm^Xm       , Mm          , Mm^Xm       , Mm^Xm       , Mm          , Mm          , Mm^Xm       , Mm          , Co          , Mm          , Mm          , Mm^Vo       , Mm^Xm       , Mm^Xm       , Mm          , Mm          , Mm          , Mm^Xm       , Mm          , Mm          , Mm^Xm       , Mm          , Mm          , Mm          
Mm          , Mm^Xm       , Mm          , Mm          , Mm          , Mm^Vo       , Mm          , Mm^Xm       , Mm^Xm       , Mm^Xm       , Mm          , Mm          , Mm          , Mm          , Mm          , Mm^Xm       , Mm          , Mm          , Mm          , Mm          , Mm          , Mm          , Mm          , Mm          , Mm          , Mm^Xm       , Mm          , Mm          , Mm          , Mm^Xm       , Mm^Xm       , Mm          , Mm          , Mm          , Mm          
Mm          , Mm          , Mm          , Mm          , Mm          , Mm          , Mm          , Mm          , Mm          , Mm          , Mm          , Mm          , Mm          , Mm          , Mm          , Mm          , Mm          , Mm          , Mm          , Mm          , Mm          , Mm          , Mm          , Mm          , Mm          , Mm          , Mm          , Mm          , Mm          , Mm          , Mm          , Mm          , Mm          , Mm          , Mm^Xm       
