border_size=1
usage=map

Xos         , Xos         , Xos         , Xos         , Xos         , Xos         , Xos         , Xos         , Xos         , Xos         , Xos         , Xos         , Xos         , Xos         , Xos         , Xos         , Xos         , Xos         , Xos         , Xos         , Xos         
Xos         , Xos         , Xos         , Xos         , Xos         , Xos         , Xos         , Xos         , Xos         , Xos         , Xos         , Xos         , Xos         , Xos         , Xos         , Xos         , Xos         , Xos         , Xos         , Xos         , Xos         
Xos         , Xos         , Xos         , Xos         , Rr          , Rr          , Rr          , Rr          , Rr          , Rr          , Rr          , Rr          , Rr          , Rr          , Rr          , Rr          , Rr          , Xos         , Xos         , Xos         , Xos         
Xos         , Xos         , Rr          , Rr          , Rrc         , Rrc         , Rrc         , Rr          , Rrc         , Rr          , 5 Kh        , Rr          , Rrc         , Rr          , Rrc         , Rrc         , Rrc         , Rr          , Rr          , Xos         , Xos         
Xos         , Xos         , Rr          , Rrc         , Ch          , Ch          , Iwr         , Rrc         , Iwr         , Rrc         , Rrc         , Rrc         , Iwr         , Rrc         , Iwr         , Ch          , Ch          , Rrc         , Rr          , Xos         , Xos         
Xos         , Xos         , Rr          , Rrc         , Ch          , Iwr         , 3 Ch        , Iwr         , Iwr         , Ch          , 2 Ch        , Ch          , Iwr         , Iwr         , 4 Ch        , Iwr         , Ch          , Rrc         , Rr          , Xos         , Xos         
Xos         , Xos         , Rr          , Rrc         , Iwr         , Iwr         , Ch          , Ch          , Iwr         , Iwr         , Iwr         , Iwr         , Iwr         , Ch          , Ch          , Iwr         , Iwr         , Rrc         , Rr          , Xos         , Xos         
Xos         , Xos         , Rr          , Rrc         , Ch          , Iwr         , Iwr         , Ch          , Iwr         , Ch          , Iwr         , Ch          , Iwr         , Ch          , Iwr         , Iwr         , Ch          , Rrc         , Rr          , Xos         , Xos         
Xos         , Xos         , Rr          , Rrc         , Rrc         , Ch          , Rrc         , Iwr         , Iwr         , Iwr         , 1 Ch        , Iwr         , Iwr         , Iwr         , Rrc         , Ch          , Rrc         , Rrc         , Rr          , Xos         , Xos         
Xos         , Xos         , Rr          , Rr          , Rr          , Rrc         , Rr          , Rrc         , Rrc         , 7 Ch        , 9 Rrc       , 8 Ch        , Rrc         , Rrc         , Rr          , Rrc         , Rr          , Rr          , Rr          , Xos         , Xos         
Xos         , Xos         , Xos         , Rr          , Xos         , Rr          , Xos         , Rr          , Rr          , Rrc         , Rrc         , Rrc         , Rr          , Rr          , Xos         , Rr          , Xos         , Rr          , Xos         , Xos         , Xos         
Xos         , Xos         , Xos         , Xos         , Xos         , Xos         , Xos         , Xos         , Rr          , Rrc         , Rrc         , Rrc         , Rr          , Xos         , Xos         , Xos         , Xos         , Xos         , Xos         , Xos         , Xos         
