border_size=1
usage=map

Mm          , Mm          , Mm          , Mm          , Mm          , Mm          , Mm          , Mm          , Hh          , Gs          , Gs          , Gs          , Ww          , Wo          , Ww          , Gs          , Gs          , Gs          , Gs          , Gs          , Gd          , Gd          , Gd          , Gd          
Mm          , Mm          , Mm          , Mm          , Mm          , Mm          , Mm          , Mm          , Hh          , Gs          , Gs          , Gs          , Ww          , Wo          , Ww          , Gs          , Gs          , Gs          , Gs          , Gs          , Gd          , Gll^Fmf     , Gll^Fmf     , Gd          
Mm          , Mm          , Mm          , Mm          , Mm          , Mm          , Mm          , Mm          , Hh          , Gs          , Gd^Vo       , Gs          , Ww          , Wo          , Ww          , Wwf         , Gs          , Gll^Fmf     , Gll^Fmf     , Gd          , Gd          , Gll^Fmf     , Gll^Fmf     , Gd          
Mm          , Mm          , Mm          , Mm          , Mm          , Mm          , Hhd         , Hhd         , Gs          , Gs          , Ce          , Gs          , Gs          , Ww          , Wo          , Ww          , Gs          , Gll^Fmf     , Gll^Fmf     , Gd          , Gd          , Gll^Fmf     , Gd          , Gd          
Mm          , Mm          , Mm          , Mm          , Mm          , Mm          , Hhd         , Gs          , Gs          , Ce          , 2 Ke        , Ce          , Gs          , Ww          , Wo          , Ww          , Gg          , Gll^Fmf     , Gs          , Gs          , Gd          , Gd          , Gd          , Gd          
Mm          , Mm          , Mm          , Mm          , Mm          , Hh          , Gs          , Gs          , Gd^Vo       , Ce          , Ce          , Ce          , Gg          , Ww          , Wo          , Ww          , Gg          , Gg          , Gs          , Gs          , Gd          , Gd          , Gd          , Gd          
Mm          , Mm          , Mm          , Mm          , Hh          , Hh          , Gs          , Gs          , Gs          , Gs          , Gs          , Gd^Vo       , Gg          , Ww          , Ww          , Ww          , Gg          , Gg          , Gs          , Gs          , Gs          , Gd          , Gd          , Gd          
Mm          , Mm          , Mm          , Mm          , Hh          , Gs          , Gs          , Gs          , Gll^Fmf     , Gs          , Gs          , Gg          , Gg          , Ww          , Wo          , Ww          , Gg          , Gg          , Gll^Fmf     , Gs          , Gs          , Gs          , Gs          , Gd          
Mm          , Mm          , Mm          , Mm          , Hhd         , Gs          , Gll^Fmf     , Gll^Fmf     , Gll^Fmf     , Gll^Fmf     , Gs          , Gg          , Gll^Fmf     , Ww          , Wo          , Ww          , Gg          , Gg          , Gll^Fmf     , Gll^Fmf     , Gs          , Gs          , Gs          , Gd          
Mm          , Mm          , Mm          , Mm          , Hhd         , Gs          , Gs          , Gll^Fmf     , Gll^Fmf     , Gll^Fmf     , Gs          , Gll^Fmf     , Gll^Fmf     , Ww          , Wo          , Ww          , Gg          , Gg          , Gg          , Gll^Fmf     , Gs          , Gs          , Gs          , Gd          
Mm          , Mm          , Mm          , Hhd         , Gs          , Gs          , Gs          , Gs          , Gs          , Gs          , Gs          , Gg          , Gg          , Ww          , Ww          , Ww          , Gg          , Gg          , Gg          , Gs          , Gs          , Gs          , Gs          , Gd          
Mm          , Mm          , Mm          , Hh          , Gs          , Gs          , Gs          , Gs          , Gs          , Gs          , Gs          , Gg          , Gg          , Ww          , Wo          , Ww          , Ww          , Gg          , Gg          , Gll^Fmf     , Gll^Fmf     , Gll^Fmf     , Gs          , Gs          
Mm          , Mm          , Hh          , Hh          , Gs          , Gll^Fmf     , Gll^Fmf     , Gd          , Gd          , Gs          , Gs          , Gg          , Gg          , Ww          , Ww          , Wo          , Ww          , Gg          , Gg          , Gll^Fmf     , Gll^Fmf     , Gll^Fmf     , Gs          , Gs          
Hh          , Hh          , Gs          , Gs          , Gs          , Gll^Fmf     , Gd          , Gd          , Gd          , Gs          , Gll^Fmf     , Gll^Fmf     , Gll^Fmf     , Gg          , Ww          , Wo          , Ww          , Wwf         , Gg          , Gs          , Gs          , Gs          , Gs          , Gs          
Gs          , Gs          , Gs          , Gs          , Co          , Gd          , Gd          , Gd          , Gd^Vo       , Gs          , Gll^Fmf     , Gll^Fmf     , Gll^Fmf     , Gg          , Gg          , Ww          , Wo          , Ww          , Gg          , Gs          , Gs          , Gs          , Gs          , Gs          
Gs          , Co          , Gd          , Gd          , Gd^Vo       , Co          , Gd          , Gd          , Gd          , Gs          , Gs          , Gll^Fmf     , Gg          , Gg          , Gg          , Ww          , Wo          , Ww          , Ww          , Gg          , Re^Vct      , Gs          , Gs          , Gs          
Gd          , Gd          , Gd^Vo       , Gd          , Gd          , Gd          , Co          , Gd          , Gd          , Gs          , Gs          , Gs          , Gs          , Gg          , Gg          , Ww          , Ww          , Wo          , Ww          , Gg          , Gg          , Gs          , Gs          , Gs          
Gd          , Gd          , Co          , Co          , Co          , Gd          , Gd          , Gd          , Gd          , Gs          , Gs          , Gs          , Gs          , Gg          , Gg          , Gg          , Ww          , Ww          , Ww          , Gg          , Gg          , 1 Re^Vct    , Gs          , Gg          
Gd          , Gd^Vo       , Co          , 3 Ko        , Gd^Vo       , Gd          , Gd          , Co          , Gd          , Gd          , Gd          , Gs^Fms      , Gs^Fms      , Gg          , Gg          , Gg          , Ww          , Wo          , Ww          , Gg          , Re^Vct      , Gg          , Gs          , Gs          
Gd          , Gd          , Gd          , Co          , Gd          , Gd          , Co          , Gd          , Gd          , Gd          , Gd          , Gs^Fms      , Gs          , Gs          , Gg          , Gg          , Ww          , Wo          , Ww          , Gg          , Gg          , Gg          , Re^Vct      , Gs          
Gd          , Gd          , Gd          , Gd          , Gd          , Co          , Gd          , Gd          , Gd          , Gd          , Gd          , Gd          , Gg          , Gs          , Gg          , Gg          , Ww          , Wo          , Ww          , Gg          , Gg          , Gs          , Gs          , Gs          
