border_size=1
usage=map

Gll^Fmf     , Gd^Fdf      , Gll^Fmf     , Gll^Fmf     , Gll^Fmf     , Gll^Fmf     , Gll^Fmf     , Gll^Fmf     , Gll^Fmf     , Gll^Fmf     , Gll^Fmf     , Gll^Fmf     , Gll^Fmf     , Gll^Fmf     , Gll^Fmf     , Gll^Fmf     , Ww          , Ww          , Gll^Fmf     , Gll^Fmf     , Gll^Fmf     , Gd^Fdf      , Gll^Fmf     , Gll^Fmf     , Gll^Fmf     , Gd^Fdf      , Gll^Fmf     , Gll^Fmf     , Gll^Fmf     , Gll^Fmf     , Gll^Fmf     , Gll^Fmf     , Gll^Fmf     , Gll^Fmf     , Gll^Fmf     
Gll^Fmf     , Gll^Fmf     , Gll^Fmf     , Gll^Fmf     , Gll^Fmf     , Gll^Fmf     , Gll^Fmf     , Gll^Fmf     , Gll^Fmf     , Gll^Fmf     , Gd^Fdf      , Gll^Fmf     , Gg^Ve       , Gll^Fmf     , Gll^Fmf     , Gll^Fmf     , Ww          , Ww          , Gll^Fmf     , Gll^Fmf     , Gll^Fmf     , Gll^Fmf     , Gll^Fmf     , Gll^Fmf     , Gd^Fdf      , Gll^Fmf     , Gd^Fdf      , Gll^Fmf     , Gll^Fmf     , Gll^Fmf     , Gd^Fdf      , Gll^Fmf     , Gd^Fdf      , Gd^Fdf      , Gll^Fmf     
Gll^Fmf     , Gll^Fmf     , Gg^Fet      , Gll^Fmf     , Gll^Fmf     , Gll^Fmf     , Gll^Fmf     , Gll^Fmf     , Rb          , Gll^Fmf     , Gll^Fmf     , Gll^Fmf     , Gll^Fmf     , Gll^Fmf     , Gd^Fdf      , Ww          , Wwf         , Wwf         , Gd^Fdf      , Gll^Fmf     , Gll^Fmf     , Gd^Fdf      , Gll^Fmf     , Gll^Fmf     , Gll^Fmf     , Gll^Fmf     , Gll^Fmf     , Gll^Fmf     , Rb          , Gll^Fmf     , Rb          , Rb          , Re^Vct      , Gd^Fdf      , Gll^Fmf     
Gll^Fmf     , Gll^Fmf     , Gll^Fmf     , Gll^Fmf     , Rb          , Rb          , Rb          , Rb          , Rb          , Rb          , Rb          , Gll^Fmf     , Gll^Fmf     , Gll^Fmf     , Gll^Fmf     , Ww          , Wwf         , Gll^Fmf     , Gll^Fmf     , Gll^Fmf     , Gd^Fdf      , Gll^Fmf     , Gll^Fmf     , Gll^Fmf     , Gll^Fmf     , Gll^Fmf     , Gll^Fmf     , Re^Vct      , Rb          , Rb          , Ce          , Rb          , Rb          , Gll^Fmf     , Gll^Fmf     
Gll^Fmf     , Gll^Fmf     , Gll^Fmf     , Gll^Fmf     , Rb          , Re^Vct      , Ce          , Rb          , Ce          , Rb          , Rb          , Gll^Fmf     , Gll^Fmf     , Gd^Fdf      , Gll^Fmf     , Ww          , Wwf         , Gll^Fmf     , Gll^Fmf     , Gll^Fmf     , Gll^Fmf     , Gll^Fmf     , Gll^Fmf     , Gg^Fet      , Gll^Fmf     , Gll^Fmf     , Gll^Fmf     , Rb          , Rb          , Ce          , 3 Ke        , Rb          , Rb          , Gll^Fmf     , Gd^Fdf      
Gll^Fmf     , Gd^Fdf      , Gll^Fmf     , Rb          , Rb          , Ce          , 2 Ke        , Ce          , Rb          , Re^Vct      , Rb          , Gd^Fdf      , Gll^Fmf     , Gll^Fmf     , Gll^Fmf     , Ww          , Ww          , Gll^Fmf     , Gll^Fmf     , Gll^Fmf     , Gll^Fmf     , Gll^Fmf     , Gg^Ve       , Gll^Fmf     , Gll^Fmf     , Gll^Fmf     , Gll^Fmf     , Gll^Fmf     , Rb          , Ce          , Rb          , Ce          , Rb          , Gll^Fmf     , Gll^Fmf     
Gll^Fmf     , Gll^Fmf     , Gll^Fmf     , Rb          , Ce          , Ce          , Ce          , Ce          , Rb          , Rb          , Rb          , Gd^Fdf      , Gll^Fmf     , Gll^Fmf     , Gd^Fdf      , Ww          , Ww          , Gll^Fmf     , Gll^Fmf     , Gll^Fmf     , Gll^Fmf     , Gll^Fmf     , Gd^Fdf      , Gll^Fmf     , Gll^Fmf     , Gll^Fmf     , Gll^Fmf     , Gll^Fmf     , Rb          , Rb          , Rb          , Re^Vct      , Rb          , Gd^Fdf      , Gll^Fmf     
Gll^Fmf     , Gll^Fmf     , Gll^Fmf     , Rb          , Re^Vct      , Rb          , Rb          , Rb          , Re^Vct      , Rb          , Gll^Fmf     , Gll^Fmf     , Gll^Fmf     , Gll^Fmf     , Gll^Fmf     , Wwf         , Ww          , Gll^Fmf     , Gd^Fdf      , Gll^Fmf     , Gd^Fdf      , Gll^Fmf     , Gll^Fmf     , Gd^Fdf      , Gll^Fmf     , Gd^Fdf      , Gll^Fmf     , Gll^Fmf     , Gll^Fmf     , Re^Vct      , Gll^Fmf     , Rb          , Gll^Fmf     , Gll^Fmf     , Gll^Fmf     
Gd^Fdf      , Gd^Fdf      , Gll^Fmf     , Gll^Fmf     , Gll^Fmf     , Rb          , Rb          , Rb          , Gd^Fdf      , Gll^Fmf     , Gll^Fmf     , Gd^Fdf      , Gll^Fmf     , Gll^Fmf     , Wwf         , Wwf         , Ww          , Gll^Fmf     , Gll^Fmf     , Gll^Fmf     , Gll^Fmf     , Gd^Fdf      , Gll^Fmf     , Gll^Fmf     , Gll^Fmf     , Gll^Fmf     , Gll^Fmf     , Gll^Fmf     , Gll^Fmf     , Gll^Fmf     , Gll^Fmf     , Gll^Fmf     , Gll^Fmf     , Gll^Fmf     , Gll^Fmf     
Gll^Fmf     , Gd^Fdf      , Gg^Ve       , Gll^Fmf     , Gll^Fmf     , Gll^Fmf     , Gll^Fmf     , Gll^Fmf     , Gll^Fmf     , Gll^Fmf     , Gd^Fdf      , Gd^Fdf      , Ww          , Ww          , Ww          , Ww          , Ww          , Ww          , Ww          , Gll^Fmf     , Gll^Fmf     , Gd^Fdf      , Gll^Fmf     , Gll^Fmf     , Gll^Fmf     , Gll^Fmf     , Gll^Fmf     , Gg^Ve       , Gll^Fmf     , Gll^Fmf     , Gll^Fmf     , Gll^Fmf     , Gll^Fmf     , Gd^Fdf      , Gll^Fmf     
Gll^Fmf     , Gll^Fmf     , Gll^Fmf     , Gll^Fmf     , Gll^Fmf     , Gll^Fmf     , Gll^Fmf     , Gll^Fmf     , Gll^Fmf     , Gll^Fmf     , Wwf         , Ww          , Ww          , Ww          , Gll^Fmf     , Gll^Fmf     , Gll^Fmf     , Ww          , Ww          , Gll^Fmf     , Gll^Fmf     , Gll^Fmf     , Gd^Fdf      , Gll^Fmf     , Gll^Fmf     , Gll^Fmf     , Gll^Fmf     , Gll^Fmf     , Gd^Fdf      , Gll^Fmf     , Gll^Fmf     , Gll^Fmf     , Gd^Fdf      , Gd^Fdf      , Gll^Fmf     
Ww          , Gll^Fmf     , Gll^Fmf     , Gll^Fmf     , Gll^Fmf     , Gd^Fdf      , Ww          , Gll^Fmf     , Wwf         , Gll^Fmf     , Wwf         , Ww          , Gll^Fmf     , Gd^Fdf      , Gll^Fmf     , Gll^Fmf     , Gll^Fmf     , Ww          , Ww          , Wwf         , Gll^Fmf     , Gll^Fmf     , Gll^Fmf     , Gll^Fmf     , Gll^Fmf     , Gll^Fmf     , Gll^Fmf     , Gd^Fdf      , Gll^Fmf     , Gll^Fmf     , Gd^Fdf      , Gll^Fmf     , Gll^Fmf     , Gll^Fmf     , Gll^Fmf     
Ww          , Ww          , Wwf         , Gll^Fmf     , Wwf         , Ww          , Ww          , Ww          , Ww          , Wwf         , Ww          , Ww          , Gll^Fmf     , Gll^Fmf     , Gll^Fmf     , Gll^Fmf     , Gll^Fmf     , Gll^Fmf     , Ww          , Wwf         , Wwf         , Gll^Fmf     , Gll^Fmf     , Gll^Fmf     , Gll^Fmf     , Gll^Fmf     , Gll^Fmf     , Gll^Fmf     , Gll^Fmf     , Gll^Fmf     , Gll^Fmf     , Gll^Fmf     , Gll^Fmf     , Gll^Fmf     , Gll^Fmf     
Gll^Fmf     , Ww          , Ww          , Wwf         , Ww          , Ww          , Gll^Fmf     , Ww          , Gll^Fmf     , Ww          , Gd^Fdf      , Gll^Fmf     , Gll^Fmf     , Gll^Fmf     , Gll^Fmf     , Gll^Fmf     , Gll^Fmf     , Gd^Fdf      , Gll^Fmf     , Ww          , Ww          , Wwf         , Gll^Fmf     , Gll^Fmf     , Gll^Fmf     , Gll^Fmf     , Ww          , Ww          , Ww          , Gll^Fmf     , Gd^Fdf      , Gll^Fmf     , Wwf         , Gll^Fmf     , Gll^Fmf     
Gll^Fmf     , Gll^Fmf     , Gll^Fmf     , Ww          , Gll^Fmf     , Gll^Fmf     , Gll^Fmf     , Gd^Fdf      , Gll^Fmf     , Gll^Fmf     , Gll^Fmf     , Gll^Fmf     , Gll^Fmf     , Gll^Fmf     , Gll^Fmf     , Gll^Fmf     , Gll^Fmf     , Gd^Fdf      , Gll^Fmf     , Gll^Fmf     , Ww          , Ww          , Ww          , Gll^Fmf     , Ww          , Ww          , Wwf         , Wwf         , Wwf         , Ww          , Ww          , Wwf         , Ww          , Wwf         , Wwf         
Gll^Fmf     , Gll^Fmf     , Gll^Fmf     , Gd^Fdf      , Gll^Fmf     , Gll^Fmf     , Gll^Fmf     , Gll^Fmf     , Gll^Fmf     , Gll^Fmf     , Gll^Fmf     , Gll^Fmf     , Gll^Fmf     , Gll^Fmf     , Gg^Ve       , Gll^Fmf     , Gll^Fmf     , Gll^Fmf     , Gll^Fmf     , Gll^Fmf     , Gll^Fmf     , Ww          , Ww          , Ww          , Wwf         , Wwf         , Gll^Fmf     , Gd^Fdf      , Gll^Fmf     , Ww          , Ww          , Ww          , Gd^Fdf      , Ww          , Ww          
Gd^Fdf      , Gd^Fdf      , Gll^Fmf     , Gd^Fdf      , Gll^Fmf     , Gll^Fmf     , Gll^Fmf     , Gll^Fmf     , Gll^Fmf     , Gll^Fmf     , Gll^Fmf     , Gg^Fet      , Gd^Fdf      , Gll^Fmf     , Gll^Fmf     , Gd^Fdf      , Gd^Fdf      , Gll^Fmf     , Gll^Fmf     , Gd^Fdf      , Gll^Fmf     , Wwf         , Ww          , Ww          , Wwf         , Gll^Fmf     , Gll^Fmf     , Gll^Fmf     , Gd^Fdf      , Gll^Fmf     , Gll^Fmf     , Gll^Fmf     , Gll^Fmf     , Gll^Fmf     , Gll^Fmf     
Gll^Fmf     , Gll^Fmf     , Gll^Fmf     , Gll^Fmf     , Gll^Fmf     , Gll^Fmf     , Gll^Fmf     , Gd^Fdf      , Gll^Fmf     , Gll^Fmf     , Gll^Fmf     , Gll^Fmf     , Gd^Fdf      , Gll^Fmf     , Gll^Fmf     , Gll^Fmf     , Gll^Fmf     , Gll^Fmf     , Gll^Fmf     , Gd^Fdf      , Gll^Fmf     , Gll^Fmf     , Wwf         , Ww          , Ww          , Gll^Fmf     , Gll^Fmf     , Gll^Fmf     , Gll^Fmf     , Gll^Fmf     , Gll^Fmf     , Gll^Fmf     , Gll^Fmf     , Gll^Fmf     , Gd^Fdf      
Gll^Fmf     , Gll^Fmf     , Gll^Fmf     , Gll^Fmf     , Gll^Fmf     , Gll^Fmf     , Gd^Fdf      , Gd^Fdf      , Gll^Fmf     , Gd^Fdf      , Gll^Fmf     , Gll^Fmf     , Gll^Fmf     , Gll^Fmf     , Gd^Fdf      , Gd^Fdf      , Gll^Fmf     , Gd^Fdf      , Gll^Fmf     , Gll^Fmf     , Gll^Fmf     , Gll^Fmf     , Gll^Fmf     , Wwf         , Wwf         , Ww          , Gll^Fmf     , Gll^Fmf     , Gll^Fmf     , Gg^Ve       , Gll^Fmf     , Gll^Fmf     , Gll^Fmf     , Gll^Fmf     , Gd^Fdf      
Gll^Fmf     , Gd^Fdf      , Gll^Fmf     , Gll^Fmf     , Gd^Fdf      , Gg^Ve       , Gll^Fmf     , Gll^Fmf     , Gll^Fmf     , Gd^Fdf      , Gd^Fdf      , Gll^Fmf     , Gd^Fdf      , Gll^Fmf     , Gll^Ve      , Gll^Fmf     , Ce          , Gll^Fmf     , Gll^Fmf     , Gd^Fdf      , Gll^Fmf     , Gll^Fmf     , Gd^Fdf      , Gll^Fmf     , Wwf         , Ww          , Ww          , Gll^Fmf     , Gll^Fmf     , Gll^Fmf     , Gll^Fmf     , Gll^Fmf     , Gll^Fmf     , Gd^Fdf      , Gll^Fmf     
Gll^Fmf     , Gll^Fmf     , Gll^Fmf     , Gll^Fmf     , Gll^Fmf     , Gll^Fmf     , Gll^Fmf     , Gd^Fdf      , Gll^Fmf     , Gll^Fmf     , Gll^Fmf     , Gll^Fmf     , Gs          , Gs          , Gs          , Gs          , Ce          , Ke          , Ce          , Gll^Fmf     , Gll^Fmf     , Gll^Fmf     , Gll^Fmf     , Gd^Fdf      , Gll^Fmf     , Ww          , Ww          , Gll^Fmf     , Gll^Fmf     , Gll^Fmf     , Gll^Fmf     , Gll^Fmf     , Gll^Fmf     , Gll^Fmf     , Gll^Fmf     
Gll^Fmf     , Gll^Fmf     , Gll^Fmf     , Gll^Fmf     , Gll^Fmf     , Gll^Fmf     , Gll^Fmf     , Gll^Fmf     , Gll^Fmf     , Gll^Fmf     , Gll^Fmf     , Gs          , Gs          , Re^Vct      , Re^Vct      , Gs          , Gs          , Ce          , Gs          , Gd^Fdf      , Gll^Fmf     , Gll^Fmf     , Gll^Fmf     , Gll^Fmf     , Gll^Fmf     , Ww          , Ww          , Gd^Fdf      , Gll^Fmf     , Gll^Fmf     , Gll^Fmf     , Gll^Fmf     , Gll^Fmf     , Gll^Fmf     , Gd^Fdf      
Gd^Fdf      , Gll^Fmf     , Gll^Fmf     , Gll^Fmf     , Gll^Fmf     , Gll^Fmf     , Gll^Fmf     , Gll^Fmf     , Gll^Fmf     , Gd^Fdf      , Gll^Fmf     , Gs          , Gs^Vct      , 1 Re^Vct    , Gs          , Gs          , Gs          , Gs          , Gs          , Gll^Fmf     , Gll^Fmf     , Gll^Fmf     , Gll^Fmf     , Gll^Fmf     , Gd^Fdf      , Ww          , Ww          , Gd^Fdf      , Gd^Fdf      , Gll^Fmf     , Gd^Fdf      , Gg^Ve       , Gll^Fmf     , Gll^Fmf     , Gll^Fmf     
Gll^Fmf     , Gll^Fmf     , Gll^Fmf     , Gll^Fmf     , Gll^Fmf     , Gll^Fmf     , Gll^Fmf     , Gll^Fmf     , Gll^Fmf     , Gll^Fmf     , Gd^Fdf      , Gs          , Gs          , Gs          , Gs          , Gs          , Gs          , Gs          , Gll^Fmf     , Gll^Fmf     , Gll^Fmf     , Gll^Fmf     , Gd^Fdf      , Gll^Fmf     , Gll^Fmf     , Ww          , Ww          , Gll^Fmf     , Gll^Fmf     , Gll^Fmf     , Gll^Fmf     , Gll^Fmf     , Gll^Fmf     , Gll^Fmf     , Gll^Fmf     
