border_size=1
usage=map

Xu          , Xu          , Xu          , Xu          , Xu          , Xu          , Xu          , Xu          , Uu          , Uu          , Ur          , Uu          , Uu          , Uu          , Xu          , Xu          , Xu          , Xu          , Xu          , Xu          , Xu          , Xu          , Xu          , Xu          , Xu          , Xu          , Xu          , Xu          
Xu          , Xu          , Xu          , Xu          , Xu          , Xu          , Xu          , Xu          , Uu          , Uu          , Ur          , Ur          , Uu          , Uu          , Uu          , Xu          , Uu^Uf       , Xu          , Xu          , Xu          , Xu          , Xu          , Xu          , Xu          , Xu          , Xu          , Xu          , Xu          
Xu          , Xu          , Xu          , Xu          , Xu          , Xu          , Uh          , Uh          , Uu          , Uu^Uf       , Uu^Uf       , Uu          , Uu          , Uu          , Uh          , Uh          , Uu          , Uu^Uf       , Xu          , Xu          , Xu          , Xu          , Xu          , Xu          , Xu          , Xu          , Xu          , Xu          
Xu          , Xu          , Uu^Uf       , Xu          , Uu          , Uu          , Uh          , Uh          , Uu          , Uu          , Uu          , Uu          , Ur          , Uu          , Uh          , Uu          , Uu          , Uu          , Uu          , Xu          , Xu          , Xu          , Xu          , Xu          , Mm^Xm       , Xu          , Mm^Xm       , Mm^Xm       
Uu          , Uu          , Uu^Uf       , Uu^Uf       , Uu          , Ur          , Uu          , Uu          , Ur          , Ur          , Uu^Uf       , Uh          , Ur          , Uu          , Uu          , Uu          , Uu^Uf       , Uu^Uf       , Uu          , Uu          , Xu          , Xu          , Mm^Xm       , Mm^Xm       , Mm^Xm       , Mm^Xm       , Mm^Xm       , Mm^Xm       
Uu          , Uu          , Uu^Vu       , Uu          , Ur          , Ur          , Uu^Uf       , Uu^Uf       , Ur          , Uu^Uf       , Uu          , Uh          , Uh          , Ur          , Uu^Uf       , Ur          , Uu          , Uu^Uf       , Uu          , Uh          , Mm^Xm       , Mm^Xm       , Mm^Xm       , Mm^Xm       , Mm          , Mm^Xm       , Mm          , Mm          
Uu          , Ur          , Uu          , Uu          , Co          , Uu          , Uu          , Uu^Uf       , Uu          , Uu          , Uu          , Uu          , Uu          , Uu          , Uu          , Ur          , Ur          , Uu          , Uh          , Uh          , Uh^Ii       , Mm^Xm       , Ms          , Mm          , Mm          , Mm          , Mm          , Mm          
Uu          , Ur          , Ur          , Co          , 2 Ko        , Co          , Uu          , Uu^Vu       , Uu          , Uu^Uf       , Uh          , Uh          , Uh          , Uu          , Uu^Uf       , Uu^Uf       , Uu          , Uu          , Aa          , Coa         , Aa          , Ha          , Ha          , Ms          , Ms          , Mm          , Mm          , Mm          
Uu          , Uu          , Uu          , Co          , Co          , Co          , Uu          , Uu          , Uu          , Uu^Uf       , Xu          , Xu          , Xu          , Uu          , Xu          , Uu          , Uu^Ii       , Uh          , Coa         , Aa          , Aa          , Aa          , Aa          , Hh          , Ms          , Ms          , Ms          , Mm          
Uu          , Uu          , Uu^Vu       , Ur          , Uu          , Uu          , Ur          , Uh          , Xu          , Xu          , Xu          , Xu          , Xu          , Xu          , Xu          , Xu          , Uh^Ii       , Uh^Ii       , Aa          , Aa          , Aa          , Coa         , Aa          , Hh          , Ha          , Ms          , Ms          , Mm          
Uu          , Uu          , Uu          , Uu          , Ur          , Ur          , Uh          , Uh          , Xu          , Xu          , Xu          , Xu          , Mm^Xm       , Xu          , Ms^Xm       , Mm^Xm       , Hh          , Aa          , Aa          , Aa          , Aa^Fmw      , Aa          , Aa^Fdw      , Aa          , Ha          , Ms          , Ms          , Ms          
Uu          , Uu          , Xu          , Uu          , Uu          , Uu          , Xu          , Xu          , Xu          , Xu          , Xu          , Mm^Xm       , Ms^Xm       , Ms^Xm       , Mm^Xm       , Mm^Xm       , Hh          , Aa          , Coa         , Aa          , Aa^Fda      , Aa^Fda      , Aa^Fma      , Aa          , Aa          , Ha          , Hh          , Ms          
Xu          , Xu          , Xu          , Xu          , Xu          , Xu          , Xu          , Xu          , Xu          , Xu          , Mm^Xm       , Mm^Xm       , Mm^Xm       , Ms^Xm       , Mm          , Mm          , Ha          , Aa          , Aa          , Aa          , Aa^Fda      , Aa^Fma      , Gs^Fdw      , Aa          , Gd          , Aa          , Gd          , Hh          
Xu          , Xu          , Xu          , Xu          , Xu          , Xu          , Xu          , Xu          , Ms^Xm       , Ms^Xm       , Ms^Xm       , Mm^Xm       , Mm          , Mm          , Ms          , Mm          , Ha          , Aa          , Aa          , Aa          , Aa          , Gd^Fmw      , Gd          , Gd          , Gd          , Gd          , Gd          , Gd          
Xu          , Xu          , Xu          , Xu          , Xu          , Xu          , Mm^Xm       , Ms^Xm       , Ms^Xm       , Ms^Xm       , Mm          , Mm          , Ms          , Ms          , Hh          , Ha          , Aa          , Aa          , Gd          , Gd          , Gd          , Gd          , Gd          , Gd          , Gd          , Gd          , Gd          , Gd          
Mm^Xm       , Ms^Xm       , Ms^Xm       , Xu          , Mm^Xm       , Mm^Xm       , Ms^Xm       , Ms^Xm       , Mm          , Mm          , Mm          , Mm          , Hh          , Hh          , Gd          , Aa          , Gd          , Gd          , Gd          , Gd          , Gd^Fmw      , Gd          , Gd^Fmw      , Gd^Fmw      , Gd          , Gd          , Gd          , Gd          
Mm^Xm       , Ms^Xm       , Ms^Xm       , Ms^Xm       , Ms^Xm       , Ms^Xm       , Ms^Xm       , Ms^Xm       , Mm          , Mm          , Ms          , Mm          , Ha          , Aa          , Gd          , Gd          , Gd          , Gd          , Gd          , Gd          , Aa^Fmw      , Gd^Fmw      , Aa^Fetd     , Aa^Fmw      , Aa          , Gd          , Gd          , Gd          
Mm          , Mm          , Mm          , Mm^Xm       , Mm          , Mm          , Mm          , Mm          , Ms          , Ms          , Ha          , Ha          , Aa          , Aa          , Gd          , Gd          , Gd          , Gd          , Gd          , Aa^Fmw      , Aa^Fda      , Aa^Fda      , Aa^Fmw      , Aa^Fmw      , Aa          , Gd          , Gd          , Gd          
Mm          , Mm          , Mm          , Mm          , Ms          , Ms          , Ms          , Mm          , Hh          , Hh          , Aa          , Aa          , Gd          , Gd          , Gd          , Gd          , Gd          , Gd          , Gd          , Aa^Fmw      , Aa^Fda      , Aa^Fma      , Aa^Voa      , Aa          , Gd          , Gd          , Gd          , Gd          
Mm          , Mm          , Mm          , Mm          , Ms          , Ms          , Ms          , Hh          , Gd          , Gd          , Gd          , Gd          , Gd^Fmw      , Gd          , Gd          , Gd          , Gd          , Gd          , Gd          , Gd^Fmw      , Aa^Fmw      , Aa^Fda      , Aa^Fmw      , Gd          , Gd          , Gd          , Gd          , Gd          
Mm          , Mm          , Mm          , Mm          , Ms          , Ms          , Ha          , Hh          , Aa          , Gd          , Gd          , Gd^Fmw      , Gd^Fmw      , Gd          , Aa          , Gd          , Gd          , Gd          , Gd          , Gd          , Gd          , Aa          , Gd          , Gd          , Gd          , Gd          , Gd          , Gd          
Mm          , Mm          , Mm          , Ms          , Ha          , Ha          , Aa          , Aa          , Aa          , Gd          , Gd          , Gd^Fmw      , Aa^Fda      , Aa^Fmw      , Aa^Fmw      , Aa          , Gd          , Gd          , Gd          , Gd          , Gd          , Gd          , Gd          , Gd          , Gd          , Gd          , Gd          , Gd          
Mm          , Mm          , Mm          , Ms          , Ha          , Aa          , Aa          , Aa          , Gd^Fmw      , Gd^Fmw      , Gd^Fmw      , Gs^Fdw      , Aa^Fma      , Aa^Fma      , Aa^Fmw      , Aa          , Aa          , Gd          , Gd          , Gd          , Aa^Fmw      , Gd^Fmw      , Gd^Fmw      , Gd^Fmw      , Gd          , Gd          , Gd          , Gd          
Ms^Xm       , Ms^Xm       , Ms^Xm       , Ha          , Hh          , Aa          , Aa          , Gd          , Gd^Fmw      , Gd^Fetd     , Gd^Fmw      , Aa^Fdw      , Aa          , Aa          , Aa          , Aa          , Aa          , Gd          , Gd          , Gd          , Aa          , Aa^Fma      , Aa^Fma      , Aa^Fmw      , Gd          , Gd          , Gd          , Gd          
Ms          , Ms^Xm       , Ms          , Hh          , Ha          , Aa          , Aa          , Gd          , Gd          , Gd^Fmw      , Gd          , Aa          , Aa          , Aa^Voa      , Aa          , Aa          , Gd          , Gd          , Gd          , Gd          , Gd          , Aa          , Aa          , Aa          , Gd          , Gd          , Gd          , Gd          
Ms          , Ms          , Hh          , Hh          , Aa          , Aa          , Aa          , Gd          , Gd          , Gd          , Gd          , Gd          , Aa          , Aa          , Aa          , Gd          , Gd          , Gd          , Gd          , Gd          , Gd          , Gd          , Gd          , Gd          , Gd          , Gd          , Gd          , Gd          
Ha          , Ha          , Aa          , Aa          , Aa          , Aa          , Gd          , Gd          , Gd^Fmw      , Gd^Fmw      , Gd^Fma      , Aa          , Aa          , Aa          , Aa^Fma      , Gd^Fdw      , Gd^Fdw      , Gd          , Aa          , Gd          , Gd          , Gd          , Gd^Fmw      , Gd          , Gd          , Gd          , Gd          , Gd          
Aa          , Aa          , Aa          , Aa          , Aa          , Gd          , Gd          , Gd          , Gd^Fdw      , Gd^Fmw      , Aa^Fma      , Aa^Fma      , Aa          , Aa          , Aa^Fma      , Aa^Fma      , Gd^Fmw      , Aa^Fdw      , Aa^Fma      , Aa          , Gd          , Gd          , Aa          , Gd^Fmw      , Gd^Fmw      , Gd          , Gd          , Gd          
Aa          , Aa          , Aa          , Aa^Voa      , Aa          , Gd          , Gd          , Gd          , Gd          , Gd^Fdw      , Gd^Fdw      , Aa^Fdw      , Gd          , Aa          , Aa          , Aa          , Aa          , Aa^Fma      , Aa^Fma      , Aa          , Aa          , Aa          , Aa^Voa      , Aa          , Gd^Fmw      , Gd          , Gd          , Gd          
Gd          , Aa          , Aa          , Aa          , Aa^Fma      , Aa^Fmw      , Aa          , Gd          , Gd          , Gd          , Gd          , Gd          , Gd          , Gd          , Gd          , Gd          , Gd          , Aa          , Aa^Fmw      , Aa          , Aa          , Aa^Fma      , Aa^Fma      , Aa^Fma      , Gd^Fmw      , Gd          , Gd          , Gd          
Gd          , Gd          , Aa          , Aa^Fma      , Aa^Fma      , Aa          , Aa          , Aa          , Gd^Fdw      , Gd          , Gd          , Gd          , Gd          , Gd          , Gd          , Gd^Fdw      , Gd^Fdw      , Aa          , Aa          , Gd          , Aa          , Aa^Fma      , Aa^Fma      , Aa^Fetd     , Gd^Fmw      , Gd          , Gd          , Gd          
Gd          , Gd          , Gd          , Aa^Fmw      , Gd^Fdw      , Aa          , Aa^Fetd     , Aa^Fma      , Gd^Fmw      , Gd^Fmw      , Gd          , Gd          , Aa          , Aa          , Aa^Fma      , Gd^Fdw      , Aa^Fma      , Aa^Fma      , Gd          , Gd          , Gd          , Aa^Fmw      , Aa^Fmw      , Gd^Fmw      , Gd          , Gd          , Gd          , Gd          
Gd          , Gd          , Gd          , Gd^Fmw      , Gd^Fmw      , Aa^Fdw      , Aa^Fma      , Aa^Fma      , Gd          , Gd          , Gd          , Gd          , Aa          , Aa^Fma      , Aa^Fma      , Aa^Fmw      , Aa          , Aa          , Gd          , Cea^Vct     , 1 Kea       , Gd          , Gd          , Gd          , Gd          , Gd          , Gd          , Gd          
Gd          , Gd          , Gd          , Gd          , Gd          , Aa^Fdw      , Aa          , Aa          , Gd          , Gd          , Gd          , Gd          , Gd          , Aa          , Aa          , Aa          , Gd          , Gd          , Cea         , Cea         , Cea         , Cea         , Cea         , Re^Vct      , Gd          , Gd          , Gd          , Gd          
Gd          , Gd          , Gd          , Gd          , Gd          , Gd          , Gd          , Gd          , Gd          , Gd          , Gd          , Gd          , Gd          , Gd          , Gd          , Gd          , Re^Vct      , Gd          , Gd          , Gd          , Gd          , Re^Vct      , Gd          , Gd          , Gd          , Gd          , Gd          , Gd          
Gd          , Gd          , Gd          , Gd          , Gd          , Gd          , Gd          , Gd          , Gd          , Gd          , Gd          , Gd          , Gd          , Gd          , Gd          , Gd          , Gd          , Gd          , Gd          , Gd          , Gd          , Gd          , Gd          , Gd          , Gd          , Gd          , Gd          , Gd          
