border_size=1
usage=map

Xu          , Xu          , Xu          , Xu          , Xu          , Xu          , Uu          , Ur          , Urb         , Uu          , Uu          , Uu          , Xu          , Xu          , Xu          , Xu          , Xu          , Xu          , Xu          , Xu          , Xu          , Xu          , Xu          , Xu          , Xu          , Xu          , Xu          , Xu          , Xu          , Xu          , Xu          , Xu          , Xu          , Xu          , Uu          , Uu^Uf       , Uu          , Uu          , Xu          , Xu          , Xu          , Xu          , Xu          , Xu          
Xu          , Xu          , Xu          , Xu          , Xu          , Xu          , Uu          , Uu^Ii       , Uu^Uf       , Uu          , Uu          , Uu          , Urb         , Xu          , Xu          , Xu          , Xu          , Xu          , Xu          , Xu          , Xu          , Xu          , Xu          , Xu          , Xu          , Xu          , Xu          , Xu          , Xu          , Xu          , Xu          , Xu          , Xu          , Xu          , Uu          , Uh          , Uu^Uf       , Uu          , Uu^Vud      , Xu          , Xu          , Xu          , Xu          , Xu          
Xu          , Xu          , Xu          , Xu          , Xu          , Xu          , Uu          , Uu          , Uu          , Uu          , Uu          , Uu          , Uu          , Xu          , Xu          , Xu          , Xu          , Xu          , Xu          , Xu          , Xu          , Xu          , Xu          , Xu          , Xu          , Xu          , Xu          , Xu          , Xu          , Xu          , Xu          , Xu          , Xu          , Xu          , Uu          , Uu          , Uu          , Uu          , Uu          , Uu^Ii       , Uu^Uf       , Xu          , Uu          , Uu          
Xu          , Xu          , Xu          , Xu          , Xu          , Xu          , Xu          , Uh          , Uu          , Uu          , Uu^Uf       , Uu          , Uu          , Uu^Uf       , Xu          , Xu          , Xu          , Xu          , Xu          , Xu          , Xu          , Xu          , Xu          , Xu          , Xu          , Xu          , Xu          , Xu          , Xu          , Xu          , Xu          , Xu          , Uu          , Uu          , Urb         , Uu          , Uu          , Uh          , Uu          , Uu          , Urb         , Uh          , Uu          , Ur          
Xu          , Xu          , Xu          , Xu          , Xu          , Xu          , Xu          , Uu          , Uu          , Uu          , Uu          , Uu          , Uu          , Uu          , Xu          , Xu          , Xu          , Xu          , Xu          , Xu          , Xu          , Xu          , Xu          , Xu          , Xu          , Xu          , Xu          , Xu          , Xu          , Xu          , Urb         , Uu          , Co          , Co          , 2 Ko        , Uu          , Co          , Uh          , Uu          , Uh          , Ur          , Uu          , Uu          , Uu          
Xu          , Xu          , Xu          , Xu          , Xu          , Xu          , Xu          , Uu          , Uu          , Urb         , Uu          , Uh          , Uu          , Uu^Vud      , Uu          , Xu          , Xu          , Xu          , Xu          , Xu          , Xu          , Xu          , Xu          , Xu          , Xu          , Xu          , Xu          , Xu          , Uu          , Uu          , Uu          , Uu          , Uu          , Co          , Uu          , Co          , Co          , Uh          , Uu          , Uh          , Uu          , Uu          , Xu          , Uu          
Xu          , Xu          , Uu          , Xu          , Xu          , Xu          , Uu^Ii       , Uu          , Uu          , Urb         , Uu          , Uu          , Uu^Uf       , Uu          , Uu          , Xu          , Xu          , Xu          , Xu          , Xu          , Xu          , Xu          , Xu          , Xu          , Xu          , Xu          , Xu          , Uh          , Uh          , Uu          , Uh          , Uu          , Uu^Vud      , Uu          , Uu          , Ur          , Uu          , Uh          , Uu          , Urb         , Xu          , Xu          , Xu          , Xu          
Uu          , Uu          , Uu          , Uu          , Uu          , Uh          , Uh          , Uu          , Cud         , Uu          , Uh          , Urb         , Uu^Uf       , Uu          , Uu          , Uu          , Uu          , Xu          , Xu          , Xu          , Xu          , Xu          , Xu          , Xu          , Xu          , Xu          , Xu          , Uu          , Ur          , Uh          , Xu          , Xu          , Uu          , Uh          , Uh          , Uu          , Uu          , Uh          , Uu          , Uu          , Xu          , Xu          , Xu          , Xu          
Uu          , Uu          , Uu          , Uh          , Uu          , Cud         , 4 Kud       , Urb         , Cud         , Uu          , Uu          , Uu^Uf       , Uu          , Uu^Ii       , Uu          , Uu          , Uu^Ii       , Urb         , Uh          , Uu          , Uu          , Xu          , Xu          , Xu          , Xu          , Xu          , Uu          , Uu          , Ur          , Xu          , Xu          , Xu          , Xu          , Urb         , Uh          , Uu          , Uu          , Uu          , Xu          , Xu          , Xu          , Xu          , Xu          , Xu          
Uh          , Uu          , Uh          , Uu          , Uh          , Uu          , Cud         , Cud         , Uu          , Cud         , Uu          , Uu          , Uu          , Uh          , Uu          , Uu          , Uh          , Uu          , Uu          , Uu          , Uu^Ii       , Uu          , Uu          , Uu          , Uu          , Uu^Vud      , Uu^Ii       , Uu          , Xu          , Xu          , Xu          , Xu          , Uu          , Ur          , Uu          , Uu          , Uh          , Xu          , Xu          , Xu          , Xu          , Xu          , Xu          , Xu          
Uh          , Uu^Vud      , Uu^Uf       , Uh          , Uh          , Uu          , Uu          , Uu          , Uu^Uf       , Uu          , Uu          , Uu          , Uu          , Uu^Uf       , Uu          , Uu          , Uu          , Uu          , Uu          , Uu          , Uu^Uf       , Ur          , Uu          , Uu^Uf       , Uh          , Uu          , Urb         , Xu          , Xu          , Xu          , Xu          , Xu          , Uu          , Uu          , Uu          , Uu          , Xu          , Xu          , Xu          , Xu          , Xu          , Xu          , Xu          , Xu          
Uu          , Uu          , Uh          , Uh          , Uu          , Uu          , Uu          , Uu          , Uu          , Uu^Uf       , Xu          , Xu          , Xu          , Xu          , Xu          , Uu          , Uu^Ii       , Uu          , Uh          , Uu          , Uu          , Uu          , Ur          , Urb         , Uu          , Uu          , Uu          , Xu          , Xu          , Xu          , Xu          , Uu          , Uu          , Uu          , Xu          , Xu          , Xu          , Xu          , Xu          , Xu          , Xu          , Xu          , Xu          , Xu          
Xu          , Xu          , Xu          , Ur          , Uu          , Uh          , Urb         , Uu          , Uu          , Uu^Uf       , Xu          , Xu          , Xu          , Xu          , Xu          , Xu          , Uu          , Uu          , Ur          , Urb         , Uu^Vud      , Uh          , Uu          , Uh          , Uu          , Ur          , Uu          , Uu          , Uu          , Xu          , Uu          , Uu^Uf       , Uu          , Uu          , Xu          , Xu          , Xu          , Xu          , Xu          , Xu          , Xu          , Xu          , Xu          , Xu          
Xu          , Xu          , Xu          , Uu^Uf       , Uu          , Uu          , Urb         , Uu^Vud      , Uu          , Xu          , Xu          , Xu          , Xu          , Xu          , Xu          , Xu          , Uu          , Uu          , Uu          , Uu          , Uu          , Uh          , Uu          , Uu          , Xu          , Uu          , Uu          , Uh          , Uu          , Uu          , Uu          , Uu^Ii       , Uu^Vud      , Uu          , Xu          , Xu          , Xu          , Xu          , Xu          , Xu          , Xu          , Xu          , Uu          , Uh          
Xu          , Xu          , Xu          , Uu          , Urb         , Urb         , Uu          , Uu          , Uu          , Xu          , Xu          , Xu          , Xu          , Xu          , Xu          , Uu          , Uu          , Uu          , Uu          , Uu          , Xu          , Xu          , Xu          , Xu          , Xu          , Xu          , Ur          , Uu^Uf       , Uu          , Uu          , Uh          , Uu          , Uu          , Uu          , Xu          , Xu          , Xu          , Xu          , Xu          , Xu          , Xu          , Uu          , Uu          , Uu          
Xu          , Xu          , Xu          , Uu          , Uh          , Urb         , Uh          , Uu          , Uu          , Uh          , Ur          , Xu          , Xu          , Xu          , Uu          , Uu^Ii       , Uu          , Uh          , Urb         , Uu          , Xu          , Xu          , Xu          , Xu          , Xu          , Xu          , Uu          , Urb         , Uu          , Uu          , Uu          , Ur          , Uu          , Uu          , Uh          , Xu          , Xu          , Xu          , Xu          , Xu          , Uu^Uf       , Uu          , Uh          , Uu          
Xu          , Xu          , Xu          , Xu          , Uu          , Uh          , Urb         , Uh          , Uu          , Uu          , Uu          , Uu          , Uu          , Uu          , Uh          , Uu^Vud      , Uu          , Uu          , Uu          , Uu          , Xu          , Xu          , Xu          , Xu          , Xu          , Xu          , Xu          , Uu          , Uu          , Ur          , Uu          , Uu          , Uh          , Uu          , Uu          , Xu          , Xu          , Xu          , Uu          , Uu          , Uu^Ii       , Uu          , Uh          , Uu^Uf       
Xu          , Xu          , Xu          , Xu          , Uu          , Uu^Ii       , Uu          , Urb         , Uu          , Uu          , Ur          , Uu          , Uu          , Uu^Uf       , Uu          , Uu          , Uu          , Uu          , Uu^Uf       , Uu          , Xu          , Xu          , Xu          , Xu          , Xu          , Xu          , Xu          , Uh          , Uu          , Uu          , Uu          , Uu          , Uu          , Uu          , Uu          , Uu          , Uu          , Uu^Ii       , Co          , Co          , Co          , Uu^Ii       , Uu          , Uh          
Xu          , Xu          , Xu          , Xu          , Uh          , Uu          , Uu          , Uu          , Uh          , Uh          , Uu^Vud      , Uu          , Uu^Vud      , Uu          , Uu^Ii       , Uh          , Uh          , Uu          , Uu          , Uu          , Urb         , Xu          , Xu          , Xu          , Uu          , Xu          , Uu          , Uu          , Uu          , Uu          , Ur          , Uu^Uf       , Uu          , Uh          , Uu          , Co          , Ur          , Uh          , Uu          , 3 Ko        , Co          , Urb         , Uu          , Ur          
Xu          , Xu          , Xu          , Xu          , Xu          , Uu^Uf       , Uu          , Uu          , Uu^Ii       , Uu          , Uu          , Uu          , Uu          , Uu          , Uu          , Uu          , Uu          , Uh          , Uu          , Uu          , Uu          , Uu          , Uu          , Uu          , Urb         , Uu          , Uu^Uf       , Uh          , Uu          , Uu          , Uu          , Uu          , Uh          , Uu^Ii       , Uu^Uf       , Urb         , Uu^Uf       , Uu          , Uh          , Uu^Uf       , Uu^Ii       , Uu          , Uh          , Uu          
Xu          , Xu          , Xu          , Xu          , Xu          , Uu^Uf       , Uu          , Uu          , Uu^Uf       , Uu^Uf       , Uu          , Uu          , Xu          , Xu          , Xu          , Xu          , Xu          , Uu^Ii       , Uu          , Uu          , Uu^Uf       , Uu          , Uu          , Uu          , Uh          , Uu^Uf       , Uu          , Uu          , Xu          , Uu          , Uu^Uf       , Uu^Vud      , Uu          , Uu          , Co          , Uu          , Uu          , Uh          , Uh          , Ur          , Uu          , Uu          , Xu          , Xu          
Xu          , Xu          , Xu          , Xu          , Xu          , Uh          , Urb         , Uu          , Urb         , Uu          , Ur          , Urb         , Xu          , Xu          , Xu          , Xu          , Xu          , Xu          , Uu          , Uh          , Uu^Ii       , Uu          , Ur          , Uu^Uf       , Uu          , Uu          , Urb         , Xu          , Xu          , Xu          , Xu          , Xu          , Xu          , Uu          , Co          , Co          , Uu          , Uu          , Uu          , Uu          , Uu          , Uu          , Xu          , Xu          
Xu          , Xu          , Xu          , Xu          , Xu          , Xu          , Uu          , Uu          , Uu          , Uh          , Uu^Uf       , Uu          , Xu          , Xu          , Xu          , Xu          , Xu          , Xu          , Uu          , Uu^Uf       , Uu          , Uu          , Urb         , Uu          , Uu          , Uh          , Xu          , Xu          , Xu          , Xu          , Xu          , Xu          , Xu          , Uu          , Uu          , Uu          , Uu          , Uu^Vud      , Uu          , Uu^Uf       , Xu          , Xu          , Xu          , Xu          
Xu          , Xu          , Xu          , Xu          , Xu          , Xu          , Uu          , Uu^Vud      , Uh          , Uu          , Uu          , Uu          , Xu          , Xu          , Xu          , Xu          , Xu          , Uu          , Ur          , Uu          , Ur          , Uu          , Urb         , Uu          , Uu          , Uh          , Xu          , Xu          , Xu          , Xu          , Xu          , Xu          , Xu          , Uu          , Uu^Uf       , Co          , Uu          , Uu          , Uh          , Uu          , Xu          , Xu          , Xu          , Xu          
Xu          , Xu          , Xu          , Xu          , Xu          , Xu          , Uu          , Uu          , Uu          , Uu          , Uu          , Uu          , Uu          , Xu          , Uh          , Xu          , Uu          , Ur          , Uu^Vud      , Uu          , Xu          , Uu          , Ur          , Uu          , Uu          , Urb         , Xu          , Xu          , Xu          , Xu          , Xu          , Xu          , Uu          , Uu          , Uu          , Uu^Uf       , Uu^Uf       , Uu          , Xu          , Xu          , Xu          , Xu          , Xu          , Xu          
Xu          , Xu          , Xu          , Xu          , Xu          , Xu          , Xu          , Uu          , Uu          , Uu          , Uu^Uf       , Uu          , Urb         , Uu          , Uu          , Uu          , Uu          , Uu          , Uu          , Xu          , Xu          , Xu          , Xu          , Uu          , Uu^Uf       , Uu^Vud      , Uu          , Xu          , Uu          , Xu          , Xu          , Xu          , Uu^Uf       , Uu          , Uu^Ii       , Uu^Uf       , Uh          , Uu^Ii       , Xu          , Xu          , Xu          , Xu          , Xu          , Xu          
Xu          , Xu          , Xu          , Xu          , Xu          , Xu          , Xu          , Xu          , Uu          , Uu          , Uu          , Uu^Uf       , Uu          , Ur          , Uu          , Uu          , Uu          , Ur          , Xu          , Xu          , Xu          , Xu          , Xu          , Xu          , Uh          , Uu          , Uu          , Uu          , Uu          , Uu          , Urb         , Uh          , Uu          , Uu          , Ur          , Urb         , Xu          , Xu          , Xu          , Xu          , Xu          , Xu          , Xu          , Xu          
Xu          , Xu          , Xu          , Xu          , Xu          , Xu          , Xu          , Xu          , Xu          , Uu          , Uu          , Uu          , Uu          , Uu          , Uu          , Urb         , Ur          , Uu          , Xu          , Xu          , Xu          , Xu          , Xu          , Xu          , Uu          , Uu          , Uu          , Uh          , Uu          , Ur          , Uh          , Uu          , Uu^Uf       , Uu          , Uu^Uf       , Xu          , Xu          , Xu          , Xu          , Xu          , Xu          , Xu          , Xu          , Xu          
Xu          , Xu          , Xu          , Xu          , Xu          , Xu          , Xu          , Xu          , Xu          , Xu          , Xu          , Uu          , Uu          , Ur          , Uu          , Urb         , Uu          , Uu          , Xu          , Xu          , Xu          , Xu          , Xu          , Uu^Uf       , Uu          , Uu          , Ce          , Ce          , Ce          , Uu^Ii       , Uu^Vud      , Uu          , Uu          , Uu          , Xu          , Xu          , Xu          , Xu          , Xu          , Xu          , Xu          , Xu          , Xu          , Xu          
Xu          , Xu          , Xu          , Xu          , Xu          , Xu          , Xu          , Xu          , Xu          , Xu          , Xu          , Uu          , Uu          , Uu          , Uu          , Uu          , Uu          , Uh          , Uu          , Xu          , Xu          , Xu          , Uh          , Uh          , Uu          , Uh          , Ce          , 1 Ke        , Ce          , Uu          , Urb         , Uu          , Xu          , Xu          , Xu          , Xu          , Xu          , Xu          , Xu          , Xu          , Xu          , Xu          , Xu          , Xu          
Xu          , Xu          , Xu          , Xu          , Xu          , Xu          , Xu          , Xu          , Xu          , Xu          , Xu          , Uu          , Uh          , Uu^Uf       , Urb         , Uu          , Urb         , Uu          , Uu^Uf       , Uu          , Uu          , Urb         , Uu          , Uu          , Uu          , Uu          , Uu          , Ce          , Uu^Uf       , Uh          , Uu          , Uu          , Xu          , Xu          , Xu          , Xu          , Xu          , Xu          , Xu          , Xu          , Xu          , Xu          , Xu          , Xu          
Xu          , Xu          , Xu          , Xu          , Xu          , Xu          , Xu          , Xu          , Xu          , Xu          , Xu          , Xu          , Uu          , Uu^Uf       , Uu          , Uu          , Uu          , Uh          , Uu^Uf       , Uu^Uf       , Uu          , Uu          , Ur          , Uu          , Uh          , Uu^Uf       , Uu          , Uu          , Uh          , Ur          , Uh          , Uu^Ii       , Xu          , Xu          , Xu          , Xu          , Xu          , Xu          , Xu          , Xu          , Xu          , Xu          , Xu          , Xu          
