border_size=1
usage=map

Uu          , Uu          , Ur          , Xu          , Xu          , Xu          , Xu          , Xu          , Xu          , Xu          , Rb          , Ur          , Uu          , Uu          , Xu          , Xu          , Xu          , Xu          , Xu          , Xu          , Uu          , Uu          , Xu          , Xu          , Xu          , Xu          , Xu          , Xu          , Xu          , Xu          , Xu          , Xu          , Xu          , Xu          , Xu          , Uu          , Uu          , Xu          , Xu          , Xu          , Xu          , Xu          , Xu          , Ur          , Ur          , Xu          
Xu          , Uu          , Ur          , Cud         , 6 Kud       , Xu          , Ur          , Xu          , Urb         , Rb          , Ur          , Ur          , Xu          , Xu          , Xu          , Xu          , Xu          , Xu          , Xu          , Xu          , Ur          , Uu          , Ur          , Xu          , Xu          , Xu          , Xu          , Xu          , Xu          , Xu          , Xu          , Xu          , Xu          , Xu          , Xu          , Uu          , Ur          , Xu          , Xu          , Xu          , Xu          , Xu          , Xu          , Ur          , Rb          , Xu          
Xu          , Xu          , Xu          , Cud         , Cud         , Cud         , Uu          , Uu          , Ur          , Rb          , Xu          , Xu          , Xu          , Xu          , Xu          , Xu          , Xu          , Xu          , Xu          , Xu          , Xu          , Ur          , Rb          , Rb          , Urb         , Urb         , Rb          , Xu          , Xu          , Xu          , Rb          , Xu          , Xu          , Xu          , Rb          , Ur          , Ur          , Xu          , Xu          , Xu          , Xu          , Xu          , Xu          , Rb          , Ur          , Xu          
Xu          , Xu          , Xu          , Xu          , Xu          , Xu          , Xu          , Uu          , Ur          , Xu          , Xu          , Xu          , Xu          , Xu          , Xu          , Xu          , Xu          , Xu          , Xu          , Xu          , Xu          , Xu          , Rb          , Re          , Urb         , Rb          , Ur          , Rb          , Ur          , Uu          , Uu          , Rb          , Urb         , Ur          , Urb         , Rb          , Urb         , Xu          , Xu          , Xu          , Xu          , Xu          , 5 Kud       , Cud         , Ur          , Xu          
Xu          , Xu          , Xu          , Xu          , Xu          , Xu          , Xu          , Ur          , Re          , Xu          , Xu          , Xu          , Xu          , Xu          , Xu          , Xu          , Xu          , Xu          , Xu          , Xu          , Xu          , Xu          , Ur          , Ur          , Xu          , Xu          , Xu          , Ur          , Rb          , Uu          , Xu          , Rb          , Ur          , Ur          , Xu          , Rb          , Ur          , Urb         , Ur          , Xu          , Rb          , Cud         , Cud         , Cud         , Uu          , Uu          
Xu          , Xu          , Xu          , Xu          , Xu          , Xu          , Xu          , Re          , Rb          , Rb          , Rb          , Xu          , Xu          , Xu          , Xu          , Xu          , Xu          , Xu          , Xu          , Xu          , Urb         , Rb          , Urb         , Ur          , Xu          , Xu          , Xu          , Xu          , Xu          , Xu          , Xu          , Xu          , Xu          , Xu          , Xu          , Xu          , Xu          , Ur          , Uu          , Uu          , Uu          , Rb          , Xu          , Xu          , Xu          , Uu          
Uu          , Xu          , Urb         , Xu          , Xu          , Xu          , Ur          , Urb         , Re          , Ur          , Ur          , Ur          , Uu          , Xu          , Xu          , Xu          , Ur          , Ur          , Ur          , Xu          , Rb          , Rb          , Xu          , Xu          , Xu          , Xu          , Xu          , Xu          , Xu          , Xu          , Xu          , Xu          , Xu          , Xu          , Xu          , Xu          , Xu          , Xu          , Xu          , Ur          , Ur          , Xu          , Xu          , Xu          , Xu          , Xu          
Uu          , Uu          , Cud         , Cud         , Cud         , Ur          , Urb         , Urb         , Xu          , Xu          , Xu          , Uu          , Uu          , Urb         , Rb          , Rb          , Rr          , Rr          , Rr          , Uu          , Uu          , Uu          , Xu          , Xu          , Xu          , Xu          , Xu          , Xu          , Xu          , Xu          , Uu          , Xu          , Xu          , Xu          , Xu          , Xu          , Xu          , Xu          , Xu          , Rb          , Ur          , Xu          , Xu          , Xu          , Xu          , Xu          
Xu          , Ur          , Xu          , 8 Kud       , Cud         , Ur          , Xu          , Xu          , Xu          , Xu          , Xu          , Xu          , Xu          , Urb         , Rb          , Uu^Vu       , Rr          , Uu^Vu       , Cud         , Cud         , Cud         , Rb          , Rb          , Xu          , Xu          , Xu          , Rb          , Ur          , Rb          , Rb          , Uu          , Uu          , Rb          , Xu          , Xu          , Xu          , Xu          , Xu          , Xu          , Rb          , Rb          , Xu          , Xu          , Xu          , Xu          , Xu          
Xu          , Xu          , Xu          , Xu          , Xu          , Xu          , Xu          , Xu          , Xu          , Xu          , Xu          , Xu          , Xu          , Xu          , Ur          , Urb         , Rb          , Cud         , Rr          , 4 Kud       , Cud         , Uu^Vu       , Rr          , Ur          , Ur          , Rb          , Urb         , Ur          , Ur          , Rb          , Xu          , Rb          , Rb          , Ur          , Rb          , Xu          , Xu          , Xu          , Ur          , Urb         , Re          , Xu          , Xu          , Xu          , Xu          , Xu          
Xu          , Xu          , Xu          , Xu          , Xu          , Xu          , Xu          , Xu          , Xu          , Xu          , Xu          , Xu          , Xu          , Xu          , Uu          , Ur          , Rb          , Rb          , Ur          , Uu^Vu       , Rr          , Rr          , Rr          , Uu^Vu       , Ur          , Rb          , Xu          , Xu          , Xu          , Xu          , Xu          , Xu          , Xu          , Ur          , Ur          , Rb          , Urb         , Ur          , Urb         , Urb         , Xu          , Xu          , Xu          , Xu          , Xu          , Xu          
Xu          , Xu          , Cud         , Xu          , Xu          , Xu          , Xu          , Xu          , Rb          , Ur          , Rb          , Xu          , Re          , Uu          , Uu          , Ur          , Xu          , Xu          , Xu          , Ur          , Rb          , Rr          , Uu          , Uu          , Xu          , Xu          , Xu          , Xu          , Xu          , Xu          , Xu          , Xu          , Xu          , Xu          , Xu          , Rb          , Urb         , Ur          , Rb          , Xu          , Xu          , Xu          , Xu          , Xu          , Xu          , Xu          
Urb         , Urb         , Cud         , 9 Kud       , Cud         , Xu          , Urb         , Rb          , Urb         , Ur          , Ur          , Rb          , Re          , Urb         , Xu          , Xu          , Xu          , Xu          , Xu          , Xu          , Xu          , Rb          , Uu          , Xu          , Xu          , Xu          , Ur          , Xu          , Rb          , Xu          , Ur          , Xu          , Xu          , Xu          , Xu          , Xu          , Xu          , Rb          , Uu          , Xu          , Xu          , Xu          , Xu          , Xu          , Xu          , Xu          
Urb         , Re          , Xu          , Cud         , Ur          , Uu          , Uu          , Rb          , Xu          , Xu          , Xu          , Rb          , Urb         , Urb         , Xu          , Xu          , Xu          , Xu          , Xu          , Xu          , Xu          , Ur          , Ur          , Ur          , Re          , Rb          , Ur          , Urb         , Rb          , Urb         , Ur          , Ur          , Uu          , Xu          , Xu          , Xu          , Xu          , Rb          , Uu          , Ur          , Ur          , Xu          , Xu          , Xu          , Xu          , Xu          
Xu          , Xu          , Xu          , Xu          , Ur          , Uu          , Urb         , Xu          , Xu          , Xu          , Xu          , Xu          , Rb          , Rb          , Ur          , Xu          , Xu          , Xu          , Xu          , Xu          , Rb          , Rb          , Urb         , Urb         , Rb          , Rb          , Xos         , Ur          , Xos         , Rb          , Xos         , Uu          , Uu          , Ur          , Xu          , Xu          , Xu          , Xu          , Xu          , Uu          , Ur          , Xu          , Xu          , Xu          , Xu          , Xu          
Xu          , Xu          , Xu          , Xu          , Xu          , Ur          , Urb         , Xu          , Xu          , Xu          , Xu          , Xu          , Xu          , Rb          , Ur          , Rb          , Xu          , Xu          , Ur          , Urb         , Rb          , Urb         , Xos         , Xos         , Xos         , Xos         , _s          , Xos         , _s          , Xos         , _s          , Xos         , Ur          , Ur          , Xu          , Xu          , Xu          , Xu          , Xu          , Rb          , Rb          , Xu          , Urb         , Xu          , Urb         , Xu          
Xu          , Xu          , Xu          , Xu          , Xu          , Urb         , Urb         , Xu          , Xu          , Xu          , Xu          , Xu          , Xu          , Xu          , Uu          , Ur          , Xu          , Xu          , Ur          , Urb         , Xos         , Xos         , _s          , _s          , _s          , _s          , _s          , _s          , _s          , _s          , _s          , Xos         , Rb          , Rb          , Rb          , Xu          , Xu          , Xu          , Rb          , Urb         , Rb          , Urb         , Ce          , Urb         , Ce          , Uu          
Xu          , Xu          , Xu          , Xu          , Xu          , Ur          , Urb         , Xu          , Xu          , Xu          , Xu          , Xu          , Xu          , Xu          , Uu          , Uu          , Ur          , Rb          , Urb         , Ur          , Xos         , _s          , _s          , _s          , _s          , _s          , _s          , _s          , _s          , _s          , _s          , Xos         , Xos         , Urb         , Urb         , Ur          , Ur          , Rb          , Urb         , Urb         , Xu          , Urb         , Urb         , 1 Ke        , Ce          , Uu          
Xu          , Xu          , Xu          , Xu          , Xu          , Ur          , Ur          , Xu          , Xu          , Xu          , Ur          , Ur          , Rb          , Xu          , Urb         , Ur          , Rb          , Rb          , Urb         , Xos         , Xos         , _s          , _s          , _s          , _s          , _s          , _s          , _s          , _s          , _s          , _s          , _s          , Xos         , Rb          , Rb          , Urb         , Ur          , Rb          , Xu          , Xu          , Xu          , Xu          , Urb         , Ce          , Urb         , Urb         
Xu          , Xu          , Xu          , Xu          , Rb          , Rb          , Re          , Urb         , Rb          , Rb          , Ur          , Rb          , Rb          , Urb         , Re          , Ur          , Xu          , Urb         , Re          , Ur          , Xos         , _s          , _s          , _s          , _s          , _s          , _s          , _s          , _s          , _s          , _s          , _s          , Xos         , Ur          , Rb          , Xu          , Xu          , Xu          , Xu          , Xu          , Xu          , Xu          , Xu          , Urb         , Xu          , Xu          
Ur          , Xu          , Xu          , Uu          , Uu          , Rb          , Xu          , Urb         , Urb         , Rb          , Xu          , Xu          , Xu          , Urb         , Xu          , Xu          , Xu          , Xu          , Ur          , Ur          , Uu          , Cud         , Cud         , _s          , _s          , _s          , _s          , _s          , _s          , _s          , _s          , Xos         , Uu          , Ur          , Ur          , Xu          , Xu          , Xu          , Xu          , Xu          , Xu          , Xu          , Xu          , Xu          , Xu          , Xu          
Ur          , Rb          , Cud         , Cud         , Uu          , Xu          , Xu          , Xu          , Xu          , Xu          , Xu          , Xu          , Xu          , Xu          , Xu          , Xu          , Xu          , Xu          , Xu          , Uu          , Uu          , Cud         , Xos         , _s          , _s          , _s          , _s          , _s          , _s          , _s          , Xos         , Xos         , Uu          , Uu          , Xu          , Xu          , Xu          , Xu          , Xu          , Xu          , Xu          , Xu          , Xu          , Xu          , Xu          , Xu          
Xu          , Ur          , Cud         , 7 Kud       , Cud         , Xu          , Xu          , Xu          , Xu          , Xu          , Xu          , Xu          , Xu          , Xu          , Xu          , Xu          , Xu          , Xu          , Xu          , Ur          , Ur          , Ur          , Rb          , Xos         , Xos         , _s          , Xos         , _s          , Xos         , Xos         , Xos         , Xos         , Ur          , Ur          , Xu          , Xu          , Xu          , Xu          , Xu          , Xu          , Ur          , Uu          , Uu          , Xu          , Rb          , Ur          
Xu          , Xu          , Xu          , Cud         , Rb          , Rb          , Xu          , Xu          , Xu          , Xu          , Rb          , Xu          , Xu          , Xu          , Xu          , Xu          , Xu          , Xu          , Xu          , Xu          , Xu          , Rb          , Ur          , Rb          , Urb         , Xos         , Ur          , Xos         , Rb          , Urb         , Urb         , Rb          , Ur          , Rb          , Urb         , Xu          , Xu          , Xu          , Rb          , Rb          , Ur          , Uu          , Re          , Rb          , Ur          , Ur          
Xu          , Xu          , Xu          , Xu          , Rb          , Ur          , Rb          , Xu          , Urb         , Ur          , Rb          , Urb         , Urb         , Xu          , Xu          , Xu          , Xu          , Xu          , Ur          , Xu          , Xu          , Xu          , Xu          , Ur          , Rb          , Urb         , Ur          , Rb          , Rb          , Urb         , Rb          , Rb          , Xu          , Rb          , Rb          , Urb         , Rb          , Urb         , Rb          , Ur          , Xu          , Xu          , Xu          , Rb          , Xu          , Xu          
Xu          , Xu          , Xu          , Xu          , Xu          , Ur          , Ur          , Rb          , Ur          , Ur          , Xu          , Rb          , Uu          , Uu          , Ur          , Xu          , Rb          , Rb          , Rb          , Ur          , Rb          , Xu          , Urb         , Ur          , Rb          , Urb         , Xu          , Ur          , Xu          , Xu          , Xu          , Xu          , Xu          , Xu          , Xu          , Urb         , Rb          , Urb         , Xu          , Xu          , Xu          , Xu          , Xu          , Xu          , Xu          , Xu          
Xu          , Xu          , Xu          , Xu          , Xu          , Xu          , Uu          , Rb          , Xu          , Xu          , Xu          , Xu          , Xu          , Uu          , Ur          , Urb         , Urb         , Urb         , Xu          , Ur          , Urb         , Rb          , Urb         , Rb          , Xu          , Xu          , Xu          , Xu          , Xu          , Xu          , Xu          , Xu          , Xu          , Xu          , Xu          , Xu          , Ur          , Rb          , Xu          , Xu          , Xu          , Xu          , Xu          , Xu          , Xu          , Xu          
Xu          , Xu          , Xu          , Xu          , Xu          , Xu          , Uu          , Uu          , Xu          , Xu          , Xu          , Xu          , Xu          , Ur          , Rb          , Rb          , Xu          , Xu          , Xu          , Xu          , Xu          , Rb          , Uu          , Xu          , Xu          , Xu          , Xu          , Xu          , Xu          , Xu          , Xu          , Xu          , Xu          , Xu          , Xu          , Xu          , Ur          , Urb         , Xu          , Xu          , Xu          , Xu          , Xu          , Xu          , Xu          , Xu          
Xu          , Xu          , Xu          , Xu          , Xu          , Xu          , Rb          , Ur          , Xu          , Xu          , Xu          , Xu          , Rb          , Urb         , Rb          , Urb         , Xu          , Xu          , Xu          , Xu          , Xu          , Uu          , Uu          , Ur          , Urb         , Xu          , Rb          , Xu          , Xu          , Xu          , Xu          , Xu          , Xu          , Xu          , Xu          , Xu          , Rb          , Ur          , Xu          , Xu          , Xu          , Xu          , Xu          , Xu          , Xu          , Xu          
Xu          , Xu          , Xu          , Xu          , Xu          , Rb          , Cud         , Ur          , Xu          , Xu          , Xu          , Xu          , Rb          , Urb         , Xu          , Xu          , Xu          , Xu          , Xu          , Xu          , Xu          , Xu          , Xu          , Ur          , Ur          , Urb         , Rb          , Urb         , Urb         , Xu          , Xu          , Xu          , Xu          , Xu          , Urb         , Rb          , Re          , Rb          , Cud         , Xu          , Xu          , Xu          , Xu          , Xu          , Xu          , Xu          
Xu          , Xu          , Xu          , Xu          , Cud         , 2 Kud       , Cud         , Xu          , Xu          , Xu          , Xu          , Xu          , Uu          , Rb          , Xu          , Xu          , Xu          , Xu          , Xu          , Xu          , Xu          , Xu          , Xu          , Xu          , Rb          , Urb         , Xu          , Rb          , Urb         , Re          , Uu          , Ur          , Rb          , Urb         , Rb          , Urb         , Xu          , Re          , 3 Kud       , Cud         , Xu          , Xu          , Xu          , Xu          , Xu          , Xu          
Xu          , Xu          , Xu          , Xu          , Rb          , Cud         , Xu          , Xu          , Xu          , Xu          , Xu          , Xu          , Ur          , Uu          , Xu          , Xu          , Xu          , Xu          , Xu          , Xu          , Xu          , Xu          , Uu          , Uu          , Rb          , Rb          , Xu          , Xu          , Xu          , Uu          , Uu          , Ur          , Ur          , Rb          , Xu          , Xu          , Xu          , Xu          , Cud         , Cud         , Xu          , Xu          , Xu          , Xu          , Xu          , Xu          
Xu          , Xu          , Ur          , Ur          , Rb          , Urb         , Xu          , Xu          , Xu          , Xu          , Xu          , Xu          , Ur          , Uu          , Xu          , Xu          , Xu          , Xu          , Xu          , Xu          , Urb         , Ur          , Ur          , Uu          , Xu          , Xu          , Xu          , Xu          , Xu          , Xu          , Xu          , Xu          , Xu          , Xu          , Xu          , Xu          , Xu          , Xu          , Ur          , Re          , Xu          , Xu          , Xu          , Xu          , Xu          , Xu          
Rb          , Urb         , Ur          , Rb          , Xu          , Xu          , Xu          , Xu          , Xu          , Xu          , Xu          , Xu          , Urb         , Ur          , Urb         , Xu          , Xu          , Xu          , Xu          , Xu          , Rb          , Ur          , Xu          , Xu          , Xu          , Xu          , Xu          , Xu          , Xu          , Xu          , Xu          , Xu          , Xu          , Xu          , Xu          , Xu          , Xu          , Xu          , Urb         , Urb         , Urb         , Xu          , Xu          , Xu          , Xu          , Xu          
Rb          , Rb          , Xu          , Xu          , Xu          , Xu          , Xu          , Xu          , Xu          , Xu          , Xu          , Xu          , Xu          , Rb          , Rb          , Rb          , Xu          , Xu          , Xu          , Xu          , Rb          , Rb          , Xu          , Xu          , Xu          , Xu          , Xu          , Xu          , Xu          , Xu          , Xu          , Xu          , Xu          , Xu          , Xu          , Xu          , Xu          , Xu          , Xu          , Rb          , Rb          , Rb          , Xu          , Xu          , Xu          , Xu          
