border_size=1
usage=map

Uu          , Uu          , Uu          , Ur          , Ur          , Urb         , Ur          , Urb         , Xu          , Xu          , Xu          , Xu          , Xu          , Urb         , Uu          , Urb         , Urb         , Uu          , Xu          , Xu          , Xu          
Uu          , Urb         , Urb         , Urb         , Ur          , Urb         , Ur          , Urb         , Urb         , Xu          , Xu          , Xu          , Urb         , Urb         , Uu          , Urb         , Uu          , Uu          , Xu          , Xu          , Xu          
Urb         , Urb         , Xu          , Urb         , Uu          , Uu          , Uu          , Urb         , Xos         , Xos         , Xu          , Xu          , Xos         , Ur          , Ur          , Ur          , Ur          , Urb         , Xu          , Xu          , Xu          
Xu          , Xu          , Xu          , Xu          , Xu          , Xu          , Xu          , Xu          , Cud         , Cud         , Xu          , Xu          , Xu          , Xos         , Xos         , Uu          , Urb         , Urb         , Xu          , Xu          , Xu          
Xu          , Xu          , Xu          , Xu          , Xu          , Xu          , Xu          , Xu          , Uu          , Cud         , Xu          , Xu          , Ur          , Cud         , Cud         , Xos         , Xu          , Xu          , Xu          , Xu          , Xu          
Xu          , Xu          , Xos         , Xos         , Cud         , Cud         , Urb         , Ur          , Ur          , Uu          , Rr          , Ur          , Uu          , Uu          , Urb         , Xu          , Xu          , Xu          , Xos         , Xu          , Xu          
Xu          , Xos         , Cud         , Cud         , Cud         , Urb         , Uu          , Rb          , Ur          , Uu          , Rr          , Ur          , Uu          , Urb         , Xu          , Xu          , Xu          , Xu          , Cud         , Xos         , Xu          
Xu          , Xos         , Cud         , 3 Kud       , Cud         , Urb         , Uu^Vu       , Rb          , Rb          , Rr          , Rb          , Rb          , Ur          , Urb         , Ur          , Xu          , Cud         , 4 Kud       , Cud         , Xos         , Xu          
Xu          , Xos         , Rb          , Cud         , Rb          , Uu          , Urb         , Urb         , Rp          , Rp          , Rb          , Re          , Uu          , Ur          , Rp          , Rp          , Rb          , Cud         , Uu          , Xos         , Xu          
Xu          , Xos         , Uu          , Rb          , Rr          , Rr          , Urb         , Ur          , Rp          , Re          , Xu          , Uu          , Urb         , Uu          , Rp          , Rb          , Ur          , Ur          , Uu          , Xos         , Xu          
Xu          , Xos         , Uu          , Ur          , Ur          , Rr          , Ur          , Ur          , Xu          , Xu          , Cud         , Xu          , Xu          , Urb         , Rr          , Rb          , Ur          , Uu^Vu       , Urb         , Xos         , Xu          
Xu          , Xu          , Xu          , Uu          , Ur          , Rp          , Rb          , Rp          , Xu          , Cud         , 2 Kud       , Cud         , Xu          , Urb         , Rr          , Rr          , Uu          , Urb         , Xu          , Xu          , Xu          
Xu          , Xu          , Xu          , Urb         , Urb         , Rp          , Ur          , Rb          , Xu          , Cud         , Cud         , Cud         , Xu          , Uu          , Rp          , Ur          , Uu          , Urb         , Xu          , Xu          , Xu          
Xu          , Xu          , Xu          , Xu          , Urb         , Rr          , Ur          , Rb          , Uu          , Xu          , Xu          , Xu          , Uu          , Uu          , Rp          , Ur          , Ur          , Uu          , Xu          , Xu          , Xu          
Xu          , Xu          , Xu          , Xu          , Rr          , Rr          , Rp          , Ur          , Uu          , Urb         , Urb         , Urb         , Re          , Rp          , Rb          , Rb          , Rb          , Xu          , Xu          , Xu          , Xu          
Xu          , Xu          , Xu          , Uu          , Ur          , Rb          , Rb          , Rp          , Ur          , Uu^Vu       , Ur          , Rr          , Rr          , Ur          , Ur          , Ur          , Xu          , Xu          , Xu          , Xu          , Xu          
Xu          , Xu          , Xu          , Uu          , Uu^Vu       , Ur          , Rb          , Rp          , Rr          , Ur          , Rp          , Rp          , Rr          , Re          , Uu          , Urb         , Xu          , Xu          , Xu          , Xu          , Xu          
Xu          , Xu          , Xu          , Xos         , Xos         , Ur          , Re          , Urb         , Urb         , Rr          , Rp          , Rb          , Ur          , Uu          , Urb         , Urb         , Xos         , Xu          , Xu          , Xu          , Xu          
Xu          , Xu          , Uu          , Urb         , Ur          , Cud         , 1 Kud       , Re          , Urb         , Uu          , Rb          , Rb          , Ur          , Uu          , Xos         , Xos         , Xu          , Xu          , Xu          , Xu          , Xu          
Ur          , Uu          , Urb         , Urb         , Ur          , Uu          , Uu          , Cud         , Xos         , Uu          , Uu          , Ur          , Xos         , Xos         , Xu          , Xu          , Xu          , Xu          , Xu          , Xu          , Xu          
Ur          , Ur          , Urb         , Uu          , Ur          , Ur          , Urb         , Urb         , Xu          , Xos         , Xos         , Xos         , Xu          , Xu          , Urb         , Xu          , Uu          , Uu          , Uu          , Xu          , Xu          
Ur          , Ur          , Ur          , Uu          , Uu          , Urb         , Urb         , Xu          , Xu          , Xu          , Xu          , Xu          , Urb         , Urb         , Urb         , Urb         , Uu          , Uu          , Urb         , Urb         , Urb         
