border_size=1
usage=map

Uu          , Uu          , Rb          , Xu          , Xu          , Xu          , Xu          , Xu          , Xu          , Xu          , Xu          , Xu          , Xu          , Xu          , Xu          , Xu          , Xu          , Xu          , Uu          , Uu          , Rb          
Uu          , Uu          , Rb          , Uu          , Uu          , Xu          , Xu          , Xu          , Xu          , Xu          , Xu          , Xu          , Xu          , Xu          , Xu          , Xu          , Rb          , Rb          , Uu          , Rb          , Uu          
Xu          , Uu          , Uu          , Rb          , Uu          , Rb          , Xu          , Xu          , Xu          , Xu          , Xu          , Xu          , Xu          , Xu          , Rb          , Uu          , Rb          , Rb          , Rb          , Rb          , Rb          
Xu          , Xu          , Xu          , Rb          , Uu          , Rb          , Rb          , Xu          , Rb          , Xu          , Uu          , Uu^Vu       , Rb          , Rb          , Uu          , Uu          , Rb          , Uu          , Uu          , Uu          , Xu          
Xu          , Xu          , Xu          , Rb          , Rb          , Uu          , Co          , Uu          , Rb          , Uu^Vu       , Uu          , Rb          , Uu          , Co          , Co          , Uu          , Rb          , Rb          , Xu          , Xu          , Xu          
Xu          , Xu          , Xu          , Xu          , Xu          , Rb          , Co          , Uu          , Rb          , Rb          , Co          , Rb          , Rb          , Rb          , Co          , Rb          , Rb          , Xu          , Xu          , Xu          , Xu          
Xu          , Xu          , Xu          , Xu          , Xu          , Rb          , Uu          , Rb          , Uu          , Uu          , 2 Ko        , Uu          , Uu          , Uu^Vu       , Rb          , Rb          , Xu          , Xu          , Xu          , Xu          , Xu          
Xu          , Xu          , Xu          , Xu          , Uu          , Rb          , Co          , Rb          , Uu^Vu       , Co          , Uu          , Co          , Uu          , Rb          , Rb          , Uu          , Xu          , Xu          , Xu          , Xu          , Xu          
Xu          , Xu          , Xu          , Xu          , Uu          , Co          , Rb          , Uu          , Rb          , Rb          , Uu          , Rb          , Co          , Co          , Co          , Uu          , Uu          , Xu          , Xu          , Xu          , Xu          
Xu          , Xu          , Uu          , Rb          , Rb          , Uu          , Co          , Rb          , Co          , Uu          , Uu^Vu       , Rb          , Rb          , Uu          , Rb          , Rb          , Rb          , Rb          , Xu          , Xu          , Xu          
Xu          , Xu          , Uu          , Uu          , 1 Rb        , Uu          , Uu          , Co          , Uu          , Rb          , Rb          , Rb          , Uu^Vu       , Uu          , Xu          , Rb          , Uu          , Rb          , Rb          , Xu          , Xu          
Uu          , Uu          , Uu          , Rb          , Uu          , Rb          , Xu          , Uu          , Xu          , Xu          , Xu          , Rb          , Xu          , Xu          , Xu          , Xu          , Uu          , Rb          , Rb          , Uu          , Uu          
Rb          , Rb          , Rb          , Uu          , Xu          , Xu          , Xu          , Xu          , Xu          , Xu          , Xu          , Xu          , Xu          , Xu          , Xu          , Xu          , Xu          , Uu          , Rb          , Rb          , Uu          
Rb          , Uu          , Rb          , Uu          , Xu          , Xu          , Xu          , Xu          , Xu          , Xu          , Xu          , Xu          , Xu          , Xu          , Xu          , Xu          , Xu          , Xu          , Xu          , Uu          , Uu          
