border_size=1
usage=map

Dd          , Dd          , Dd          , Dd          , Dd          , Dd          , Dd          , Dd^Edpp     , Dd          , Dd^Es       , Dd          , Dd          , Dd^Esd      , Dd^Es       , Dd          , Dd^Es       , Dd          , Dd          , Dd          , Dd          , Dd          , Dd          , Dd          , Dd          , Dd^Edpp     , Dd          , Dd          , Dd          , Dd          , Dd          
Dd          , Dd          , Dd          , Dd          , Dd          , Dd          , Dd          , Dd          , Dd^Vda      , Dd          , Dd          , Dd^Edp      , Dd          , Dd          , Dd^Vda      , Dd          , Dd^Edpp     , Dd          , Dd          , Dd          , Dd^Esd      , Dd          , Dd          , Dd          , Dd^Esd      , Dd          , Dd          , Dd          , Dd          , Dd          
Dd          , Dd          , Dd          , Dd          , Dd          , Dd          , Dd          , Dd          , Dd^Edp      , Dd          , Cd          , Cd          , Cd          , Dd          , Dd          , Dd          , Dd^Esd      , Dd          , Dd          , Dd          , Dd          , Dd          , Dd          , Dd^Vdt      , Dd          , Dd^Edpp     , Dd          , Dd          , Dd^Esd      , Dd^Edp      
Dd          , Dd          , Dd          , Dd          , Dd^Edpp     , Dd          , Dd          , Cd          , Dd          , Dd          , Cd          , 5 Kd        , Cd          , Dd          , Dd^Edpp     , Cd          , Dd          , Dd          , Dd^Es       , Dd          , Dd          , Dd          , Dd          , Dd          , Dd          , Dd^Edp      , Dd^Vdt      , Dd^Edpp     , Dd          , Dd          
Dd          , Dd          , Dd          , Dd          , Dd          , Dd          , Dd          , Dd          , Dd          , Dd^Edpp     , Dd          , Cd          , Dd          , Dd          , Dd          , Dd          , Dd          , Dd          , Dd^Edpp     , Dd          , Dd          , Dd          , Ce          , Ce          , Dd          , Dd          , Dd          , Dd          , Dd          , Dd          
Ww          , Dd          , Dd          , Dd          , Dd^Es       , Dd^Edpp     , Dd          , Dd^Esd      , Cd          , Dd          , Dd^Vda      , Dd          , Dd          , Cd          , Dd          , Dd          , Dd          , Dd          , Dd          , Dd          , Dd          , Dd          , Dd          , 6 Ke        , Ce          , Dd^Edp      , Dd          , Dd^Edp      , Dd          , Dd          
Ww          , Ww          , Ww          , Dd          , Ww          , Dd          , Dd          , Dd          , Dd          , Dd          , Dd          , Dd          , Dd^Edp      , Dd          , Dd          , Dd          , Dd          , Dd          , Dd          , Dd          , Dd          , Dd^Vdt      , Dd          , Ce          , Dd          , Dd          , Dd          , Dd          , Dd^Es       , Dd          
Dd          , Ww          , Wwf         , Ww          , Ww          , Ww          , Ww          , Dd          , Dd          , Dd          , Dd          , Cd          , Dd          , Dd          , Dd          , Dd          , Dd          , Dd          , Dd          , Dd          , Dd          , Dd^Esd      , Dd          , Dd          , Dd          , Dd^Vdt      , Dd          , Dd          , Dd          , Dd          
Dd          , Dd          , Dd          , Wwf         , Dd          , Ww          , Ww          , Ww          , Ww          , Dd          , Wwf         , Dd          , Dd          , Dd^Esd      , Dd          , Dd          , Dd          , Dd          , Dd          , Dd          , Dd          , Dd^Edp      , Dd          , Dd          , Dd          , Dd          , Dd          , Dd^Esd      , Dd^Es       , Dd          
Dd          , Dd          , Dd^Esd      , Dd          , Dd          , Dd          , Dd          , Ww          , Ww          , Ww          , Wwf         , Wwf         , Ww          , Ww          , Ww          , Dd          , Dd          , Dd          , Dd          , Dd          , Dd          , Dd          , Dd          , Dd          , Dd          , Dd          , Dd^Edpp     , Dd          , Dd          , Dd          
Gd          , Gd          , Gd          , Aa          , Aa          , Dd          , Dd          , Dd          , Dd          , Wwf         , Dd          , Ww          , Ww          , Ww          , Ww          , Ww          , Ww          , Ww          , Ww          , Dd          , Dd          , Dd          , Dd          , Dd          , Dd          , Dd          , Dd          , Dd          , Dd          , Dd          
Gd          , Gd          , Aa          , Aa          , Aa          , Aa          , Aa          , Dd          , Dd          , Dd          , Dd^Edpp     , Dd^Edp      , Dd          , Dd          , Dd          , Wwf         , Wwf         , Ww          , Ww          , Wwf         , Wwf         , Dd          , Dd^Esd      , Dd^Es       , Dd^Edp      , Dd          , Dd          , Dd          , Dd          , Dd^Esd      
Gd          , Gd          , Aa          , Aa          , Aa          , Aa          , Aa          , Dd          , Dd          , Dd^Edp      , Dd          , Dd          , Dd          , Dd          , Dd          , Dd          , Dd          , Dd          , Dd          , Wwf         , Wwf         , Wwf         , Wwf         , Dd          , Dd          , Dd          , Dd          , Dd          , Dd          , Dd          
Gd          , Gd          , Gd          , Aa          , Aa^Fda      , Aa^Fda      , Aa^Fda      , Gd          , Gd          , Dd          , Aa          , Dd          , Aa          , Dd^Edp      , Aa          , Dd          , Dd          , Dd          , Dd          , Dd^Es       , Dd          , Wwf         , Ww          , Ww          , Ww          , Dd          , Dd          , Dd          , Dd          , Dd          
Gd          , Gd          , Gd          , Aa^Fda      , Gd          , Aa^Fda      , Aa^Fda      , Gd          , Gd          , Aa          , Aa          , Aa          , Aa          , Aa          , Aa          , Aa          , Dd          , Dd          , Aa          , Dd          , Aa          , Dd          , Dd          , Ww          , Ww          , Ww          , Dd          , Dd          , Dd          , Dd          
Hhd         , Gd          , Aa          , Gd          , Gd          , Gd          , Aa          , Gd          , Gd          , Gd          , Gd          , Aa          , Aa          , Aa          , Aa          , Aa          , Gd          , Dd          , Aa          , Aa          , Aa          , Dd          , Aa          , Dd^Es       , Wwf         , Ww          , Ww          , Dd          , Dd^Es       , Dd          
Hh          , Ha          , Ha^Fda      , Ha          , Ha          , Aa          , Aa          , Aa          , Ha          , Gd          , Gd          , Gd          , Aa^Fda      , Aa^Fda      , Aa^Fda      , Gd          , Gd          , Gd          , Aa          , Aa          , Aa          , Aa          , Aa          , Dd          , Dd          , Wwf         , Ww          , Ww          , Ww          , Dd          
Hh          , Ha^Fda      , Ha^Fda      , Ha^Fda      , Ha          , Ha          , Ha^Fda      , Ha          , Ha          , Hhd         , Hhd         , Gd          , Gd          , Aa^Fda      , Gd          , Gd          , Gd          , Gd          , Aa^Fda      , Aa^Fda      , Aa^Fda      , Aa          , Gd          , Dd          , Dd          , Dd          , Dd          , Ww          , Ww          , Ww          
Aa          , Aa          , Aa          , Hhd         , Hhd         , Hhd         , Hhd         , Ha^Fda      , Ha^Fda      , Ha          , Ha          , Hh          , Hh          , Gd          , Gd          , Gd          , Gd          , Gd          , Aa          , Aa^Fda      , Aa^Fda      , Aa^Fda      , Gd          , Gd          , Aa          , Dd          , Dd^Es       , Dd^Esd      , Dd          , Ww          
Aa          , Aa          , Aa^Voa      , Aa          , Gd          , Gd          , Gd          , Hhd         , Aa          , Ha          , Ha          , Ha          , Hh          , Hhd         , Hhd         , Hhd         , Ha          , Aa          , Aa          , Aa          , Gd          , Gd          , Gd          , Aa          , Aa          , Aa          , Aa          , Dd          , Dd          , Dd          
Aa          , Aa          , Rb          , Rb          , Rb          , Gd          , Aa          , Aa          , Hh          , Hh          , Coa         , Hhd         , Hh          , Hh          , Hh          , Hh          , Hhd         , Ha          , Ha          , Ha          , Ha          , Gd          , Gd          , Aa          , Aa          , Aa          , Aa          , Aa          , Gd          , Dd          
Gd          , Rb          , Coa         , Coa         , Coa         , Rb          , Aa          , Aa^Voa      , Hh          , Coa         , Coa         , Hh          , Gd          , Gd          , Coa         , Hhd         , Hhd         , Hh          , Ha          , Ha^Fda      , Ha^Fda      , Ha          , Ha          , Aa          , Aa          , Aa          , Aa^Fda      , Aa^Fda      , Gd          , Gd          
Gd          , Rb          , Coa         , 3 Koa       , Coa         , Rb          , Rb          , Aa          , Rb          , Rb          , Rb          , Hh          , Gd          , Gd          , Coa         , Coa         , Aa          , Ha          , Coa         , Ha          , Hhd         , Ha          , Hh          , Gd          , Gd          , Gd          , Aa^Fda      , Aa^Fda      , Gd          , Gd          
Gd          , Rb          , Rb          , Coa         , Rb          , Rb          , Gd          , Rb          , Hh          , Hh          , Hhd         , Rb          , Rb          , Gd          , Gd          , Rb          , Aa^Voa      , Aa          , Coa         , Coa         , Hh          , Hhd         , Hh          , Hhd         , Gd          , Gd          , Gd          , Aa^Fda      , Gd          , Gd          
Aa          , Aa          , Aa^Voa      , Rb          , Gd          , Gd          , Gd          , Coa         , Coa         , Hh          , Hhd         , Aa^Voa      , Rb          , Gd          , Rb          , Rb          , Rb          , Rb          , Gd          , Gd          , Gd          , Hh          , Hh          , Hhd         , Hhd         , Gd          , Aa          , Aa          , Aa          , Gd          
Ha          , Aa          , Aa          , Aa          , Gd          , Gd          , Ha          , Coa         , Rb          , Hhd         , Rb          , Rb          , Gd          , Rb          , Coa         , Coa         , Coa         , Rb          , Aa          , Aa          , Aa          , Gd          , Coa         , Hh          , Hh          , Ha          , Ha          , Aa          , Aa          , Aa          
Mm          , Ha          , Ha          , Hhd         , Hh          , Ha          , Ha          , Hh          , Gd          , Rb          , Aa^Voa      , Aa          , Gd          , Rb          , Coa         , 2 Koa       , Coa         , Rb          , Aa          , Aa^Voa      , Aa          , Gd          , Coa         , Coa         , Hh          , Ha^Fda      , Ha^Fda      , Ha          , Ha          , Aa          
Ms          , Ms          , Ms          , Ha          , Hh          , Ha          , Ha          , Hh          , Gd          , Aa          , Aa          , Aa          , Rb          , Rb          , Rb          , Coa         , Rb          , Rb          , Rb          , Rb          , Rb          , Rb          , Hh          , Hhd         , Hhd         , Ha          , Ha          , Ha          , Ha          , Ha          
Ms          , Ms          , Ms          , Mm          , Mm          , Hhd         , Hh          , Hh          , Hh          , Gd          , Coa         , Rb          , Aa          , Aa^Voa      , Aa          , Rb          , Gd          , Gd          , Rb          , Aa          , Aa          , Rb          , Ha          , Ha          , Aa          , Gd          , Rb          , Aa          , Aa^Voa      , Ha          
Mm          , Ms          , Mm          , Mm          , Ms          , Mm          , Ha          , Hhd         , Hh          , Coa         , Coa         , Rb          , Hhd         , Aa          , Coa         , Rb          , Rb          , Gd          , Rb          , Aa^Voa      , Aa          , Rb          , Rb          , Aa^Voa      , Rb          , Rb          , Coa         , Rb          , Rb          , Aa          
Mm          , Mm          , Ms          , Ms          , Ms          , Ms          , Ms^Xm       , Ha          , Ha          , Hh          , Hh          , Hhd         , Hhd         , Hh          , Coa         , Coa         , Hh          , Hh          , Hhd         , Rb          , Rb          , Hh          , Hh          , Rb          , Rb          , Coa         , 4 Koa       , Coa         , Rb          , Gd          
Mm          , Mm          , Ms          , Ms          , Ms^Xm       , Ms^Xm       , Ms^Xm       , Ms^Xm       , Ha          , Hh          , Hh          , Hhd         , Hh          , Hh          , Hhd         , Hhd         , Hh          , Hh          , Hhd         , Hh          , Coa         , Coa         , Aa          , Aa          , Rb          , Coa         , Coa         , Coa         , Rb          , Gd          
Ms          , Ms          , Ms          , Ms          , Ms^Xm       , Ms^Xm       , Ms^Xm       , Ms^Xm       , Xu          , Hhd         , Hh          , Hhd         , Ha          , Ha          , Ha          , Hh          , Hhd         , Hhd         , Hhd         , Hh          , Hh          , Coa         , Aa          , Aa          , Gd          , Rb          , Rb          , Rb          , Aa          , Rb          
Ms          , Ms          , Mm^Xm       , Mm^Xm       , Mm^Xm       , Ms^Xm       , Mm^Xm       , Xu          , Uh^Ii       , Uh^Ii       , Uh^Ii       , Ha          , Ha          , Ha          , Ha          , Ha          , Hhd         , Hhd         , Ha          , Ha          , Ha          , Ha          , Ha          , Hhd         , Hhd         , Gd          , Aa          , Aa^Voa      , Aa          , Gd          
Ms          , Ms          , Mm^Xm       , Mm^Xm       , Mm^Xm       , Mm^Xm       , Xu          , Xu          , Ur^Ii       , Uh^Ii       , Uu^Ii       , Uh^Ii       , Uu^Ii       , Hhd         , Hhd         , Hh          , Xu          , Ha          , Ha          , Ha          , Ha          , Ha          , Ha          , Hhd         , Hh          , Hh          , Ha          , Aa          , Hhd         , Gd          
Ms^Xm       , Ms^Xm       , Ms^Xm       , Mm^Xm       , Mm^Xm       , Xu          , Uh          , Uh          , Ur          , Ur^Ii       , Ur          , Uu^Ii       , Ur^Ii       , Uh^Ii       , Uh^Ii       , Xu          , Ms^Xm       , Ms^Xm       , Ms^Xm       , Ms          , Ms          , Ha          , Mm          , Mm          , Mm          , Ha          , Ms          , Ha          , Ha          , Hh          
Ms^Xm       , Ms^Xm       , Ms^Xm       , Ms^Xm       , Xu          , Xu          , Uh          , Ur          , Ce          , Uu          , Uu^Vct      , Ur          , Uu^Ii       , Uh^Ii       , Xu          , Xu          , Ms^Xm       , Ms^Xm       , Ms^Xm       , Ms          , Ms          , Ms          , Mm          , Mm          , Ms          , Ms          , Ms          , Ms          , Mm          , Hh          
Mm^Xm       , Ms^Xm       , Xu          , Xu          , Uh          , Uu^Uf       , Ur          , Ce          , 1 Ke        , Ce          , Ur          , Ur          , Uu^Uf       , Xu          , Mm^Xm       , Ms^Xm       , Ms^Xm       , Ms^Xm       , Ms          , Ms          , Ms          , Ms          , Mm          , Mm          , Mm          , Ms          , Ms          , Ms          , Mm          , Mm          
Xu          , Xu          , Xu          , Uh          , Ur          , Uu^Uf       , Uu          , Ce          , Ce          , Ce          , Ur          , Uu          , Xu          , Xu          , Mm^Xm       , Mm^Xm       , Mm^Xm       , Mm          , Mm          , Ms          , Mm          , Mm          , Mm          , Mm          , Mm          , Mm          , Mm          , Mm          , Mm          , Mm          
Xu          , Xu          , Ur          , Uu^Uf       , Ur          , Uu^Vct      , Ur          , Ur          , Uu^Uf       , Uh          , Xu          , Xu          , Xu          , Xu          , Ms^Xm       , Mm^Xm       , Mm^Xm       , Ms          , Ms          , Mm          , Mm          , Mm          , Ms          , Mm          , Ms          , Ms          , Ms          , Ms          , Ms          , Mm          
Uu          , Uu          , Ur          , Ur          , Uu          , Ur          , Ur          , Uu          , Uu^Uf       , Uh          , Xu          , Xu          , Ms^Xm       , Ms^Xm       , Ms^Xm       , Ms^Xm       , Ms          , Ms          , Ms          , Mm          , Ms          , Ms          , Ms          , Ms          , Ms          , Ms          , Ms          , Ms          , Mm          , Mm          
Uu          , Uu          , Ur          , Uu          , Uu          , Ur          , Uh          , Uh          , Xu          , Xu          , Ms^Xm       , Ms^Xm       , Ms^Xm       , Ms^Xm       , Ms^Xm       , Ms^Xm       , Ms          , Ms          , Mm          , Mm          , Ms          , Ms          , Ms          , Ms          , Ms          , Ms          , Mm          , Ms          , Mm          , Mm          
