border_size=1
usage=map

Dd          , Dd          , Dd          , Dd          , Ww          , Ww          , Ww          , Dd          , Dd          , Dd          , Dd          , Dd          , Dd^Es       , Dd^Es       , Dd          , Dd          , Dd          , Dd^Edp      , Dd          , Dd          , Dd          , Dd          , Dd          , Dd^Es       , Dd          , Dd          , Dd          
Dd          , Dd^Edp      , Dd          , Dd          , Dd          , Ww          , Ww          , Ww          , Dd          , Dd          , Dd          , Dd          , Dd          , Dd          , Dd          , Dd^Edp      , Dd          , Dd          , Dd          , Dd^Es       , Dd          , Dd          , Dd^Edp      , Dd          , Dd          , Dd          , Dd          
Dd          , Dd          , Dd          , Dd          , Dd          , Dd          , Ww          , Ww          , Ww          , Dd          , Dd          , Dd          , Dd          , Dd^Es       , Dd^Esd      , Dd          , Dd          , Dd          , Dd          , Dd          , Dd          , Dd          , Dd          , Dd          , Dd          , Dd          , Dd          
Dd          , Dd          , Dd          , Dd          , Dd          , Dd          , Dd^Esd      , Ww          , Ww          , Ww          , Dd          , Dd          , Dd          , Dd          , Dd          , Dd^Es       , Md          , Dd^Edp      , Dd          , Dd          , Dd          , Dd          , Dd^Edp      , Dd          , Dd          , Dd          , Dd          
Dd^Es       , Dd          , Dd          , Dd          , Dd          , Dd^Esd      , Dd          , Dd^Edp      , Ww          , Ww          , Ww          , Dd          , Dd          , Dd^Edp      , Md          , Md          , Md          , Kd          , Md          , Dd          , Dd          , Dd          , Dd          , Dd^Esd      , Dd          , Dd          , Dd          
Dd          , Dd          , Dd          , Dd^Es       , Dd          , Dd^Edp      , Md          , Dd^Es       , Md          , Ww          , Ww          , Ww          , Ww          , Dd          , Dd^Edp      , Md          , Dd          , Md          , Md          , Md          , Md          , Dd          , Dd^Edp      , Dd          , Dd          , Dd          , Dd          
Dd          , Dd          , Dd          , Dd          , Md          , Md          , Md          , Kd          , Md          , Md          , Dd          , Ww          , Ww          , Dd          , Dd          , Dd          , Dd^Vda      , Dd^Edp      , Dd          , Md          , Md          , Md          , Dd          , Dd          , Dd          , Dd          , Dd^Esd      
Dd          , Dd^Es       , Dd          , Dd          , Md          , Md          , Md          , Md          , Dd          , Dd          , Dd          , Ww          , Ww          , Dd          , Wwf         , Dd^Esd      , Dd          , Dd^Edp      , Dd^Edp      , Dd          , Md          , Md          , Dd          , Dd^Edp      , Dd          , Dd^Esd      , Dd          
Dd          , Dd          , Dd^Es       , Md          , Md          , Md          , Dd^Es       , Dd          , Dd          , Dd^Vda      , Dd          , Ww          , Wwf         , Wwf         , Wwf         , Wwf         , Wwf         , Dd          , Dd^Vda      , Dd          , Cd          , Md          , Dd          , Dd          , Dd^Esd      , Dd          , Dd          
Dd          , Dd          , Dd          , Md          , Md          , Dd          , Dd^Vda      , Dd          , Dd          , Dd          , Wwf         , Wwf         , Wwf         , Wwf         , Kd          , Wwf         , Wwf         , Wwf         , Wwf         , Dd          , Dd          , Dd          , Dd          , Dd          , Dd^Esd      , Dd          , Dd^Edp      
Dd          , Dd^Es       , Dd^Edp      , Md          , Cd          , Dd^Es       , Dd          , Dd^Esd      , Dd          , Wwf         , Wwf         , Wwf         , Cd          , Cd          , Hd          , Cd          , Cd          , Wwf         , Wwf         , Wwf         , Dd          , Dd          , Cd          , Dd          , Dd          , Dd^Es       , Dd          
Dd          , Dd          , Dd          , Dd          , Dd^Es       , Dd^Edp      , Dd          , Dd          , Dd          , Wwf         , Wwf         , Kd          , Hd          , Hd          , Qlf         , Hd          , Hd          , 4 Kd        , Wwf         , Wwf         , Dd^Vda      , Dd          , Md          , Md          , Dd          , Dd^Esd      , Dd          
Dd          , Dd          , Dd          , Dd^Es       , Dd          , Dd          , Md          , Dd          , Dd          , Wwf         , Wwf         , Cd          , Hd          , Qlf         , 2 Hd        , Qlf         , Hd          , Cd          , Wwf         , Wwf         , Dd          , Dd          , Md          , Md          , Dd          , Dd          , Dd          
Dd          , Dd          , Dd          , Dd          , Md          , Cd          , Md          , Dd^Vda      , Dd          , Wwf         , Wwf         , Cd          , Hd          , Qlf         , Qlf         , Qlf         , Hd          , Cd          , Wwf         , Wwf         , Dd          , Dd          , Md          , Kd          , Dd          , Dd          , Dd^Edp      
Dd          , Dd          , Dd          , Dd^Es       , Kd          , Md          , Md          , Dd          , Dd^Edp      , Wwf         , Wwf         , 3 Kd        , Cd          , Hd          , Hd          , Hd          , Cd          , Kd          , Wwf         , Wwf         , Dd^Esd      , Dd          , Md          , Md          , Dd          , Dd          , Dd          
Dd          , Dd          , Dd          , Dd          , Md          , Md          , Md          , Dd          , Dd          , Wwf         , Wwf         , Wwf         , Wwf         , Cd          , Kd          , Cd          , Wwf         , Wwf         , Wwf         , Wwf         , Dd^Vda      , Dd          , Md          , Md          , Dd          , Dd          , Dd          
Dd          , Dd          , Dd^Edp      , Dd          , Dd          , Md          , Cd          , Dd          , Dd          , Dd^Vda      , Dd          , Wwf         , Wwf         , Wwf         , Wwf         , Wwf         , Wwf         , Wwf         , Dd^Es       , Dd          , Dd          , Dd          , Cd          , Md          , Dd^Esd      , Dd          , Dd^Edp      
Dd^Es       , Dd          , Dd          , Dd          , Dd          , Dd          , Dd          , Dd          , Cd          , Dd          , Dd^Es       , Dd          , Dd^Edp      , Wwf         , Wwf         , Wwf         , Ww          , Ww          , Dd          , Dd^Esd      , Dd^Es       , Dd          , Dd          , Dd          , Dd          , Dd          , Dd          
Dd          , Dd          , Dd          , Dd          , Dd          , Dd^Esd      , Dd          , Dd^Esd      , Md          , Md          , Md          , Dd          , Dd^Vda      , Dd          , Dd^Edp      , Dd          , Ww          , Ww          , Ww          , Dd          , Md          , Cd          , Dd          , Dd          , Dd          , Dd          , Dd          
Dd^Es       , Dd          , Dd          , Dd          , Dd          , Dd^Es       , Dd          , Dd          , Dd          , Md          , Md          , Md          , Md          , Dd          , Md          , Dd          , Dd          , Ww          , Ww          , Ww          , Md          , Md          , Dd          , 1 Dd        , Dd          , Dd^Edp      , Dd          
Dd          , Dd          , Dd          , Dd          , Dd          , Dd          , Dd^Edp      , Dd          , Dd          , Dd          , Md          , Md          , Md          , Md          , Md          , Md          , Md          , Dd          , Ww          , Ww          , Dd          , Dd^Edp      , Dd          , Dd          , Dd          , Dd          , Dd          
Dd^Edp      , Dd          , Dd          , Dd          , Dd          , Dd          , Dd          , Dd          , Dd          , Dd          , Dd          , Kd          , Dd          , Md          , Dd^Edp      , Md          , Dd          , Dd          , Ww          , Ww          , Ww          , Dd          , Dd          , Dd^Edp      , Dd^Es       , Dd          , Dd          
Dd          , Dd          , Dd          , Dd          , Dd          , Dd^Es       , Dd          , Dd          , Dd^Edp      , Dd^Edp      , Dd          , Dd          , Dd          , Dd          , Dd          , Dd          , Dd          , Dd^Es       , Dd          , Ww          , Ww          , Ww          , Ww          , Dd          , Dd          , Dd          , Dd          
Dd          , Dd^Es       , Dd          , Dd          , Dd          , Dd          , Dd^Edp      , Dd^Edp      , Dd^Es       , Dd          , Dd          , Dd^Edp      , Dd          , Dd          , Dd          , Dd^Edp      , Dd          , Dd          , Dd          , Dd^Edp      , Dd          , Ww          , Ww          , Ww          , Ww          , Dd          , Dd          
