border_size=1
usage=map

Dd          , Dd          , Dd          , Dd          , Dd          , Dd          , Dd          , Dd          , Dd          , Dd          , Dd          , Dd          , Dd          , Dd          , Dd          , Dd          , Dd          , Dd          , Dd          , Dd          , Dd          , Dd          , Dd          , Dd          , Dd          , Dd          , Dd          , Dd          , Dd          
Dd          , Dd^Vdt      , Dd          , Dd^Edp      , Dd          , Dd          , Dd          , Dd          , Dd^Edpp     , Dd          , Dd          , Dd          , Dd          , Dd          , Dd          , Dd          , Dd          , Dd          , Dd          , Dd          , Dd^Edpp     , Dd          , Dd          , Dd          , Dd          , Dd          , Dd          , Dd          , Dd          
Dd          , Dd          , Ce          , Dd          , Ce          , Dd^Es       , Dd          , Dd^Vdt      , Dd          , Dd          , Dd          , Dd          , Dd^Edpp     , Dd          , Dd          , Dd^Edpp     , Dd          , Dd^Es       , Dd          , Dd          , Dd          , Dd          , Dd          , Dd          , Dd          , Dd          , Dd          , Dd          , Dd          
Dd          , Dd          , Ce          , 1 Ke        , Ce          , Dd^Edp      , Dd          , Dd          , Dd          , Dd^Edp      , Dd          , Dd          , Dd          , Dd          , Dd^Es       , Dd          , Dd          , Dd          , Dd          , Dd          , Dd^Edp      , Dd          , Dd          , Dd          , Dd          , Dd          , Dd^Es       , Dd          , Dd          
Dd          , Dd^Edp      , Dd          , Ce          , Dd          , Dd          , Dd          , Dd^Es       , Dd          , Dd          , Dd          , Dd          , Dd          , Dd          , Dd          , Dd          , Dd          , Dd^Edpp     , Dd          , Dd          , Dd          , Dd          , Dd          , Dd          , Dd          , Dd^Vda      , Dd          , Dd          , Dd          
Dd          , Dd          , Dd^Vdt      , Dd          , Gs          , Gs          , Gs          , Dd          , Gd          , Gs          , Gs          , Dd          , Dd          , Dd          , Hd          , Dd          , Dd          , Dd          , Dd          , Dd^Vda      , Dd          , Dd          , Gs          , Gs          , Gd          , Dd          , Dd          , Dd          , Dd          
Gs          , Gs          , Gs          , Gs          , Gs^Fms      , Gs^Fms      , Gs          , Gs          , Gs^Fms      , Gs^Fms      , Gs          , Dd          , Dd          , Hd          , Hd          , Hd          , Ds          , Dd          , Hd          , Dd          , Dd          , Dd          , Gs          , Gs^Fms      , Gs^Fms      , Gs          , Gs          , Dd          , Dd          
Gs          , Gs          , Gs          , Gs          , Gs          , Gd          , Gs^Fms      , Gd          , Gs          , Gs          , Hd          , Hd          , Ds          , Ds          , Ww          , Ds          , Ww          , Ds          , Hd          , Hd          , Ds          , Dd          , Hd          , Gs          , Gs          , Gd          , Gs          , Gs          , Gs          
Gs          , Gd          , Gs^Fms      , Gd          , Gd          , Gs^Fms      , Gs^Fms      , Gs^Fms      , Gs          , Gs          , Hd          , Hd          , Ww          , Ww          , Wo          , Ww          , Wo          , Ww          , Ww          , Ds          , Ww          , Ds          , Hd          , Hd          , Gs          , Gs^Fms      , Gs^Fms      , Gs^Fms      , Gs          
Gs          , Gd          , Gd          , Gs^Fms      , Gs          , Gs          , Gs          , Gs          , Gd          , Gs          , Ds          , Ds          , Ww          , Wo          , Wwf         , Ww          , Ww          , Wo          , Ww          , Ww          , Wo          , Ww          , Ds          , Hd          , Gd          , Gs          , Gs          , Gd          , Ds          
Gs          , Gs          , Gs^Fms      , Gd          , Gs          , Gd          , Gs^Fms      , Gd          , Ds          , Ds          , Ww          , Ww          , Ww          , Wwf         , Wo          , Ww          , Wo          , Ww          , Ww          , Wo          , Wwf         , Ww          , Ww          , Ds          , Ds          , Ds          , Ds          , Ds          , Ww          
Gs          , Gs^Fms      , Gs^Fms      , Gd          , Gs          , Gs^Fms      , Gs          , Ds          , Ww          , Ww          , Wo          , Wo          , Ww          , Wo          , Wo          , Ww          , Wo          , Wo          , Ww          , Ww          , Wwf         , Wo          , Wo          , Ww          , Ww          , Ww          , Ww          , Ww          , Wo          
Ds          , Ds          , Ww          , Ds          , Ds          , Ds          , Ww          , Ww          , Wo          , Wo          , Ww          , Wo          , Ww          , Ww          , Ww          , Ww          , Wwf         , Wwf         , Wo          , Wo          , Ww          , Wo          , Ww          , Wo          , Wo          , Wo          , Wo          , Wo          , Ww          
Ww          , Ww          , Wo          , Ww          , Ww          , Ww          , Wo          , Wo          , Ww          , Ww          , Ds          , Ww          , Wo          , Ww          , Wwf         , Wo          , Wo          , Ww          , Ww          , Ww          , Ww          , Ww          , Ds          , Ww          , Ww          , Ww          , Ww          , Ww          , Ds          
Wo          , Wo          , Ww          , Wo          , Wo          , Wo          , Ww          , Ww          , Gs          , Ds          , Ds          , Ww          , Ww          , Wo          , Wwf         , Ww          , Ww          , Ww          , Wo          , Wo          , Ww          , Ww          , Dd          , Ds          , Ds          , Ds          , Gs          , Ds          , Gs          
Ww          , Ww          , Ds          , Ww          , Ww          , Ww          , Ds          , Ds          , Gs          , Gs          , Hd          , Ds          , Ww          , Ww          , Wo          , Wo          , Wo          , Wwf         , Ww          , Ww          , Ds          , Ds          , Dd          , Dd          , Gs          , Gs          , Gs^Fms      , Gs          , Gs          
Ds          , Ds          , Gs          , Ds          , Gs          , Ds          , Gs          , Gs          , Gs          , Gs          , Hd          , Hd          , Ds          , Ww          , Ww          , Ww          , Ww          , Wwf         , Ww          , Ww          , Hd          , Hd          , Gs          , Gs          , Gd          , Gs^Fms      , Gs^Fms      , Gs          , Gs          
Gs          , Gs          , Gs          , Gs          , Gs          , Gs          , Gd          , Gs^Fms      , Gs          , Gs          , Gs          , Hd          , Dd          , Ds          , Hd          , Ds          , Ds          , Ww          , Ds          , Ds          , Hd          , Hd          , Gs          , Gs          , Gs^Fms      , Gs          , Gs          , Gs          , Gs          
Gs          , Gs          , Gs          , Gs          , Gd          , Gs^Fms      , Gs^Fms      , Gs^Fms      , Gs          , Gs          , Gs          , Gs          , Gs          , Hd          , Hd          , Hd          , Dd          , Dd          , Dd          , Dd          , Gs          , Gs          , Gs^Fms      , Gs          , Gs^Fms      , Gs          , Gs          , Gs          , Gs          
Gs          , Gs          , Gs          , Gs          , Gs          , Gs          , Gs          , Gs          , Gs^Fms      , Gs          , Gs^Fms      , Gs^Fms      , Gs          , Gs          , Gs          , Gs          , Gs          , Gs          , Gs          , Gs          , Gs^Fms      , Gs^Fms      , Gs          , Gs          , Gs          , Gd          , Gs          , Gs          , Gs          
Gs          , Gs          , Gs          , Gs^Fms      , Gs^Fms      , Gs          , Gd          , Gs          , Gs          , Gs^Fms      , Gs          , Gs^Fms      , Gs          , Gs          , Gd          , Gs          , Gs^Fms      , Gd          , Gd          , Gs          , Gs          , Gs          , Gd          , Gs^Fms      , Gd          , Gs          , Gs^Fms      , Gs          , Gs          
Gs          , Gs          , Gs^Fms      , Gs          , Gs^Fms      , Gs          , Gs          , Gd          , Gd          , Gs          , Gs^Fms      , Gs          , Gs          , Gd          , Gs          , Gs^Fms      , Gd          , Gs          , Gd          , Gs^Fms      , Gs^Fms      , Gs          , Gs^Fms      , Gs          , Gs          , Gs          , Gs^Fms      , Gs          , Gs          
Gs          , Gs          , Gs          , Gs^Fms      , Gd          , Gs          , Gs          , Gs^Fms      , Gs^Fms      , Gs          , Gs          , Gs^Fms      , Gd          , Gs^Fms      , Gs          , Gs          , Gd          , Gs          , Gs          , Gs^Fms      , Gs^Fms      , Gs          , Gs^Fms      , Gs^Fms      , Gs          , Gs^Fms      , Gd          , Gs          , Gs          
Gs          , Gs          , Gs          , Gd          , Gs          , Gs          , Gs          , Gs          , Gs          , Gs^Fms      , Gs          , Gs^Fms      , Gs          , Gs^Fms      , Gs^Fms      , Gs          , Gd          , Gs^Fms      , Gs^Fms      , Gs          , Gs          , Gs          , Gs^Fds      , Gs          , Gd          , Gd          , Gs          , Gd          , Gs          
Gs          , Gs          , Gll^Fp      , Gll^Fp      , Gll^Fp      , Gs^Fds      , Gs^Fds      , Gs          , Gll^Fp      , Gs          , Gll^Fp      , Gll^Fp      , Gs^Fms      , Gs          , Rp          , Gs          , Gll^Fp      , Gs          , Gll^Fp      , Gll^Fp      , Gs^Fms      , Gs^Fds      , Gll^Fp      , Gll^Fp      , Gs^Fds      , Gs          , Gll^Fp      , Gs          , Gs          
Gll^Fp      , Gll^Fp      , Gll^Fp      , Gll^Fp      , Gs^Fms      , Gll^Fp      , Gs^Fms      , Gll^Fp      , Gll^Fp      , Gs^Fms      , Gll^Fp      , Gll^Fp      , Gll^Fp      , Gll^Fp      , Gs^Fds      , Rp          , Gll^Fp      , Gll^Fp      , Gs^Fds      , Gs^Fds      , Gs^Fds      , Gll^Fp      , Gs^Fds      , Gs^Fds      , Gll^Fp      , Gll^Fp      , Gs^Fds      , Gs^Fds      , Gs^Fds      
Gll^Fp      , Gs^Fms      , Gll^Fp      , Gs^Fds      , Gs^Fms      , Gs^Fds      , Gll^Fp      , Gs^Fds      , Gg^Ve       , Gs^Fms      , Gll^Fp      , Gll^Fp      , Gll^Fp      , Rp          , Rp          , Gll^Fp      , Gll^Fp      , Gll^Fp      , Gll^Fp      , Gll^Fp      , Gll^Fp      , Gll^Fp      , Gll^Fp      , Gg^Ve       , Gll^Fp      , Gll^Fp      , Gs^Fds      , Gll^Fp      , Gs^Fds      
Gll^Fp      , Gg^Ve       , Gs^Fms      , Gs^Fms      , Gs^Fms      , Gg^Ve       , Gs^Fds      , Gll^Fp      , Gll^Fp      , Gll^Fp      , Gll^Fp      , Gs^Fds      , Gll^Fp      , Gll^Fp      , Gs^Fds      , Gll^Fp      , Gll^Fp      , Gs^Fms      , Gg^Ve       , Gll^Fp      , Gs^Fds      , Gll^Fp      , Rp          , Rp          , Rp          , Gll^Fp      , Gll^Fp      , Gg^Ve       , Gll^Fp      
Gll^Fp      , Gs^Fms      , Gll^Fp      , Gll^Fp      , Rp          , Gll^Fp      , Gs^Fms      , Gll^Fp      , Gll^Fp      , Gll^Fp      , Gs^Fms      , Gll^Fp      , Gll^Fp      , Rp          , Rp          , Gs^Fms      , Gs^Fds      , Gll^Fp      , Gll^Fp      , Gs^Fms      , Gll^Fp      , Rp          , Cv          , Cv          , Cv          , Rp          , Gs^Fds      , Gll^Fp      , Hh          
Gll^Fp      , Gll^Fp      , Rp          , Rp          , Cv          , Rp          , Rp          , Gll^Fp      , Gs^Fds      , Gs^Fms      , Rp          , Gll^Fp      , Gll^Fp      , Gll^Fp      , Gs^Fds      , Gll^Fp      , Gll^Fp      , Gll^Fp      , Rp          , Gll^Fp      , Gs^Fds      , Rp          , Cv          , 2 Kv        , Cv          , Rp          , Hh          , Hh          , Mm          
Gs^Fms      , Gs^Fms      , Rp          , Cv          , 3 Kv        , Cv          , Rp          , Rp          , Rp          , Gs^Fds      , Gll^Fp      , Rp          , Gll^Fp      , Gll^Fp      , Gll^Fp      , Rp          , Rp          , Gll^Fp      , Gs^Fds      , Rp          , Rp          , Rp          , Rp          , Cv          , Rp          , Hh          , Mm          , Mm^Xm       , Mm          
Gll^Fp      , Gs^Fms      , Rp          , Cv          , Cv          , Cv          , Rp          , Gll^Fp      , Gll^Fp      , Gll^Fp      , Gll^Fp      , Gll^Fp      , Rp          , Rp          , Gg^Ve       , Gs^Fds      , Gll^Fp      , Gll^Fp      , Gll^Fp      , Gs^Fds      , Gll^Fp      , Gll^Fp      , Gll^Fp      , Rp          , Hhd         , Hh          , Mm^Xm       , Mm          , Mm          
Hh          , Gs^Fds      , Gs^Fms      , Rp          , Rp          , Rp          , Gll^Fp      , Gs^Fds      , Gs^Fds      , Gg^Ve       , Gll^Fp      , Gll^Fp      , Gs^Fds      , Gll^Fp      , Gll^Fp      , Gs^Fds      , Hh          , Gs^Fms      , Hhd         , Gs^Fms      , Gs^Fds      , Gll^Fp      , Hhd         , Hhd         , Mm^Xm       , Mm^Xm       , Mm          , Mm          , Mm          
Mm          , Hh          , Hh          , Hhd         , Hhd         , Gs^Fds      , Gs^Fds      , Gll^Fp      , Hhd         , Gll^Fp      , Gll^Fp      , Gs^Fms      , Gll^Fp      , Gs^Fds      , Hhd         , Hh          , Mm^Xm       , Hh          , Mm          , Hhd         , Hh          , Hhd         , Hh          , Mm          , Mm          , Mm          , Mm^Xm       , Mm^Xm       , Mm          
Mm          , Mm^Xm       , Mm^Xm       , Hhd         , Hh          , Hh          , Hh          , Hhd         , Mm          , Hhd         , Hh          , Hh          , Hh          , Hhd         , Mm^Xm       , Mm^Xm       , Mm          , Mm          , Mm          , Mm          , Mm          , Hh          , Mm^Xm       , Mm          , Mm          , Mm^Xm       , Mm          , Mm          , Mm          
Mm          , Mm          , Mm          , Mm^Xm       , Mm          , Mm          , Mm^Xm       , Mm^Xm       , Mm          , Mm          , Mm^Xm       , Mm^Xm       , Mm          , Mm          , Mm          , Mm          , Mm^Xm       , Mm          , Mm          , Mm^Xm       , Mm^Xm       , Mm          , Mm          , Mm^Xm       , Mm^Xm       , Mm          , Mm          , Mm^Xm       , Mm          
Mm          , Mm          , Mm          , Mm          , Mm          , Mm^Xm       , Mm          , Mm          , Mm          , Mm^Xm       , Mm          , Mm          , Mm          , Mm          , Mm^Xm       , Mm^Xm       , Mm          , Mm          , Mm          , Mm          , Mm          , Mm^Xm       , Mm          , Mm          , Mm          , Mm          , Mm          , Mm          , Mm          
Mm          , Mm          , Mm          , Mm          , Mm          , Mm          , Mm          , Mm          , Mm          , Mm          , Mm          , Mm          , Mm          , Mm          , Mm          , Mm          , Mm          , Mm          , Mm          , Mm          , Mm          , Mm          , Mm          , Mm          , Mm          , Mm          , Mm          , Mm          , Mm          
