border_size=1
usage=map

Xuce        , Xuce        , Xuce        , Xuce        , Xuce        , Xuce        , Xuce        , Xuce        , Xuce        , Uue         , Uue         , Uue         , Uue         , Uue         , Xue         , Xue         , Xue         , Xue         , Xue         , Xue         , Xue         , Xue         , Xue         , Xue         , Xue         , Uue         , Uue         , Uue         , Uue         , Uue         , Uue         
Xuce        , Xuce        , Xuce        , Xuce        , Xuce        , Xuce        , Xuce        , Xuce        , Xuce        , Uue         , Uue^Vu      , Uue         , 3 Kud       , Cud         , Uue         , Xue         , Xue         , Xue         , Xue         , Xue         , Xue         , Xue         , Xue         , Xue         , Uue         , Uue         , Cud         , Uue         , Uue^Vu      , Uue         , Uue         
Xuce        , Xuce        , Xuce        , Xuce        , Xuce        , Xuce        , Xuce        , Xuce        , Xuce        , Xuce        , Xuce        , Cud         , Cud         , Cud         , Uue         , Xue         , Rb          , Xue         , Xue         , Xue         , Xue         , Xue         , Uue         , Uue         , Cud         , 2 Kud       , Cud         , Uue         , Uue         , Uue         , Xuce        
Xuce        , Xuce        , Xuce        , Xuce        , Xuce        , Xuce        , Xuce        , Xuce        , Xuce        , Xuce        , Xuce        , Xuce        , Uue         , Uue         , Uue         , Rb          , Uue         , Uue         , Xue         , Xue         , Xue         , Uue         , Rb          , Uue         , Uue         , Cud         , Uue         , Uue         , Xuce        , Xuce        , Xuce        
Xuce        , Xuce        , Xuce        , Xuce        , Xuce        , Xuce        , Xuce        , Xuce        , Xuce        , Xuce        , Xuce        , Xuce        , Uue         , Uue^Vu      , Uue         , Uue         , Uue         , Rb          , Rb          , Xue         , Uue         , Rb          , Rb          , Uue         , Uue^Vu      , Uue         , Uue         , Xuce        , Xuce        , Xuce        , Xuce        
Uue         , Xuce        , Uue         , Xuce        , Xuce        , Xuce        , Xuce        , Xuce        , Xuce        , Xuce        , Xuce        , Xuce        , Xuce        , Uue         , Uue         , Uue         , Uue         , Rb          , Uue         , Uue         , Uue         , Rb          , Uue         , Uue         , Uue         , Uue         , Xuce        , Xuce        , Xuce        , Xuce        , Xuce        
Uue         , Uue         , Uue         , Uue         , Uue         , Xuce        , Xuce        , Xuce        , Xuce        , Xuce        , Xuce        , Xuce        , Xuce        , Xuce        , Xuce        , Uue         , Uue         , Uue         , Uue         , Uue         , Uue         , Uue         , Uue         , Uue         , Xuce        , Xuce        , Xuce        , Xuce        , Xuce        , Xuce        , Xuce        
Uue         , Uue         , Ce          , Uue         , Re^Vct      , Uue         , Uue         , Xuce        , Xuce        , Xuce        , Xuce        , Xuce        , Xuce        , Xuce        , Xuce        , Xuce        , Xuce        , Uue         , Rb          , Rb          , Uue         , Uue         , Xuce        , Xuce        , Xuce        , Xuce        , Xuce        , Xuce        , Xuce        , Xuce        , Xuce        
Uue         , Ce          , Ce          , 1 Ke        , Ce          , Uue         , Uue         , Uue         , Xuce        , Xuce        , Xuce        , Xuce        , Xuce        , Xuce        , Xuce        , Xuce        , Xuce        , Uue         , Uue         , Rb          , Uue         , Xuce        , Xuce        , Xuce        , Xuce        , Xuce        , Xuce        , Xuce        , Xuce        , Xuce        , Xuce        
Uue         , Uue         , Uue         , Ce          , Uue         , Uue         , Rb          , Re^Vct      , Uue         , Xuce        , Xuce        , Xuce        , Xuce        , Xuce        , Xuce        , Xuce        , Xuce        , Uue         , Uue         , Rb          , Uue         , Uue         , Xuce        , Xuce        , Xuce        , Xuce        , Xuce        , Xuce        , Xuce        , Xuce        , Xuce        
Xuce        , Uue         , Xuce        , Uue         , Re^Vct      , Uue         , Rb          , Uue         , Uue         , Xuce        , Xuce        , Xuce        , Xuce        , Xuce        , Xuce        , Xuce        , Xuce        , Xuce        , Xuce        , Uue         , Uue         , Rb          , Uue         , Xuce        , Xuce        , Xuce        , Xuce        , Xuce        , Xuce        , Xuce        , Xuce        
Xuce        , Xuce        , Xuce        , Xuce        , Xuce        , Uue         , Uue         , Rb          , Uue         , Xuce        , Xuce        , Xuce        , Xuce        , Xuce        , Xuce        , Xuce        , Xuce        , Xuce        , Xuce        , Uue         , Cud         , Cud         , Uue         , Xuce        , Xuce        , Xuce        , Xuce        , Xuce        , Xuce        , Xuce        , Xuce        
Xuce        , Xuce        , Xuce        , Xuce        , Xuce        , Uue         , Uue         , Uue         , Uue         , Xuce        , Xuce        , Xuce        , Xuce        , Xuce        , Xuce        , Xuce        , Xuce        , Xuce        , Xuce        , Uue         , Rb          , Cud         , Uue         , Xuce        , Xuce        , Xuce        , Xuce        , Xuce        , Xuce        , Xuce        , Xuce        
Xuce        , Xuce        , Xuce        , Xuce        , Xuce        , Xuce        , Rb          , Uue         , Uue         , Uue         , Xuce        , Xuce        , Xuce        , Xuce        , Xuce        , Xuce        , Xuce        , Xuce        , Xuce        , Uue         , Uue         , Uue         , Xuce        , Xuce        , Xuce        , Xuce        , Xuce        , Xuce        , Xuce        , Xuce        , Xuce        
Xuce        , Xuce        , Xuce        , Xuce        , Xuce        , Xuce        , Rb          , Rb          , Rb          , Uue         , Xuce        , Xuce        , Xuce        , Xuce        , Xuce        , Xuce        , Xuce        , Xuce        , Cud         , Uue         , Uue         , Uue         , Xuce        , Xuce        , Xuce        , Xuce        , Xuce        , Xuce        , Xuce        , Xuce        , Xuce        
Xuce        , Xuce        , Xuce        , Xuce        , Xuce        , Xuce        , Uue         , Rb          , Uue         , Uue         , Xuce        , Xuce        , Xuce        , Xuce        , Xuce        , Xuce        , Xuce        , Cud         , Cud         , Rb          , Uue         , Uue         , Xuce        , Xuce        , Xuce        , Xuce        , Xuce        , Xuce        , Xuce        , Xuce        , Xuce        
Xuce        , Xuce        , Xuce        , Xuce        , Xuce        , Xuce        , Xuce        , Uue         , Uue         , Uue         , Xuce        , Xuce        , Xuce        , Xuce        , Xuce        , Xuce        , Xuce        , Cud         , Rb          , Rb          , Uue         , Uue         , Xuce        , Xuce        , Xuce        , Xuce        , Xuce        , Xuce        , Xuce        , Xuce        , Xuce        
Xuce        , Xuce        , Xuce        , Xuce        , Xuce        , Xuce        , Xuce        , Uue         , Uue         , Uue         , Xuce        , Xuce        , Xue         , Xuce        , Xuce        , Xuce        , Xuce        , Uue         , Uue         , Rb          , Uue         , Uue         , Xuce        , Xuce        , Xuce        , Xuce        , Xuce        , Xuce        , Xuce        , Xuce        , Xuce        
Xuce        , Xuce        , Xuce        , Xuce        , Xuce        , Xuce        , Xuce        , Uue         , Rb          , Uue         , Uue         , Xue         , Xue         , Xue         , Xuce        , Xuce        , Xuce        , Uue         , Uue         , Uue         , Cud         , Cud         , Xuce        , Xuce        , Xuce        , Xuce        , Xuce        , Xuce        , Xuce        , Xuce        , Xuce        
Xuce        , Xuce        , Xuce        , Xuce        , Xuce        , Xuce        , Xuce        , Uue         , Rb          , Uue         , Uue         , Xue         , Xue         , Xue         , Xuce        , Xuce        , Uue         , Uue         , Rb          , Uue         , Cud         , Cud         , Xuce        , Xuce        , Xuce        , Xuce        , Xuce        , Xuce        , Xuce        , Xuce        , Xuce        
Xuce        , Xuce        , Xuce        , Xuce        , Xuce        , Xuce        , Xuce        , Uue         , Uue         , Rb          , Uue         , Uue         , Uue         , Uue         , Uue         , Uue         , Rb          , Rb          , Rb          , Uue         , Uue         , Xuce        , Xuce        , Xuce        , Xuce        , Xuce        , Xuce        , Xuce        , Xuce        , Xuce        , Xuce        
Xuce        , Xuce        , Xuce        , Xuce        , Xuce        , Xuce        , Xuce        , Xuce        , Xuce        , Uue         , Uue         , Rb          , Rb          , Uue         , Uue         , Uue         , Uue         , Rb          , Uue         , Uue         , Xuce        , Xuce        , Xuce        , Xuce        , Xuce        , Xuce        , Xuce        , Xuce        , Xuce        , Xuce        , Xuce        
Xuce        , Xuce        , Xuce        , Xuce        , Xuce        , Xuce        , Xuce        , Xuce        , Xuce        , Xuce        , Uue         , Uue         , Rb          , Rb          , Uue         , Uue         , Uue         , Uue         , Xuce        , Xuce        , Xuce        , Xuce        , Xuce        , Xuce        , Xuce        , Xuce        , Xuce        , Xuce        , Xuce        , Xuce        , Xuce        
Xuce        , Xuce        , Xuce        , Xuce        , Xuce        , Xuce        , Xuce        , Xuce        , Xuce        , Xuce        , Xuce        , Uue         , Uue         , Uue         , Uue         , Uue         , Uue         , Xuce        , Xuce        , Xuce        , Xuce        , Xuce        , Xuce        , Xuce        , Xuce        , Xuce        , Xuce        , Xuce        , Xuce        , Xuce        , Xuce        
Xuce        , Xuce        , Xuce        , Xuce        , Xuce        , Xuce        , Xuce        , Xuce        , Xuce        , Xuce        , Xuce        , Xuce        , Xuce        , Uue         , Xuce        , Uue         , Xuce        , Xuce        , Xuce        , Xuce        , Xuce        , Xuce        , Xuce        , Xuce        , Xuce        , Xuce        , Xuce        , Xuce        , Xuce        , Xuce        , Xuce        
Xuce        , Xuce        , Xuce        , Xuce        , Xuce        , Xuce        , Xuce        , Xuce        , Xuce        , Xuce        , Xuce        , Xuce        , Xuce        , Xuce        , Xuce        , Xuce        , Xuce        , Xuce        , Xuce        , Xuce        , Xuce        , Xuce        , Xuce        , Xuce        , Xuce        , Xuce        , Xuce        , Xuce        , Xuce        , Xuce        , Xuce        
