border_size=1
usage=map

Xuce        , Xuce        , Xuce        , Xuce        , Xuce        , Xuce        , Xuce        , Xuce        , Xuce        , Xuce        , Xuce        , Xuce        , Xuce        , Xuce        , Xue         , Xue         , Xue         , Xue         , Xue         , Xue         , Xue         , Xue         , Xue         , Xue         , Xue         , Xue         , Xue         
Xuce        , Xuce        , Xuce        , Xuce        , Xuce        , Xuce        , Xuce        , Xuce        , Xuce        , Xuce        , Xuce        , Xuce        , Uue         , Xuce        , Uue         , Xue         , Xue         , Xue         , Xue         , Xue         , Xue         , Xue         , Xue         , Xue         , Xue         , Xue         , Xue         
Xuce        , Xuce        , Xuce        , Xuce        , Xuce        , Xuce        , Xuce        , Xuce        , Xuce        , Xuce        , Uue         , Uue         , Uue         , Cud         , Uue         , Xue         , Uue         , Uue         , Uue         , Xue         , Uue         , Uue         , Uue         , Xue         , Uue         , Uue         , Uue         
Xuce        , Xuce        , Xuce        , Xuce        , Xuce        , Xuce        , Xuce        , Xuce        , Uue         , Uue         , Wog         , Wog         , Uue         , Uue         , Xuce        , Xuce        , Uue         , Uue         , Uue^Vu      , Uue         , Uue         , Uue^Vu      , Uue         , Uue         , Uue         , Uue         , Uue         
Xuce        , Xuce        , Xuce        , Xuce        , Xuce        , Xuce        , Xuce        , Xuce        , Uue         , Wog         , Uue         , Uue         , Xuce        , Xuce        , Xuce        , Uue         , Cud         , Urb         , Uue         , Uue         , Urb         , Uue         , Cud         , Cud         , Cud         , Uue         , Urb         
Xuce        , Xuce        , Xuce        , Xuce        , Xuce        , Xuce        , Xuce        , Xuce        , Uue         , Wog         , Uue         , Xuce        , Xuce        , Xuce        , Xue         , Uue         , Uue         , Uue         , Uue         , Urb         , Uue^Vu      , Uue         , Cud         , 2 Kud       , Cud         , Urb         , Urb         
Xuce        , Xuce        , Xuce        , Xuce        , Xuce        , Xuce        , Xuce        , Xuce        , Cud         , Uue         , Xuce        , Xuce        , Xue         , Xue         , Uue         , Xuce        , Xuce        , Uue         , Uue         , Uue         , Uue         , Urb         , Urb         , Cud         , Uue         , Uue         , Uue         
Xuce        , Xuce        , Xuce        , Xuce        , Xuce        , Xuce        , Xuce        , Xuce        , Xuce        , Xuce        , Xuce        , Xuce        , Xue         , Uue         , Cud         , Uue         , Xuce        , Xuce        , Xuce        , Xuce        , Xuce        , Uue         , Uue         , Uue         , Uue         , Uue         , Uue         
Xuce        , Xuce        , Xuce        , Xuce        , Xuce        , Xuce        , Xuce        , Xuce        , Xuce        , Xuce        , Cud         , Xuce        , Xuce        , Uue         , Uue         , Uue         , Uue         , Xuce        , Xuce        , Xuce        , Xuce        , Xuce        , Xuce        , Uue         , Xuce        , Uue         , Xuce        
Xuce        , Xuce        , Xuce        , Xuce        , Xuce        , Xuce        , Xuce        , Xuce        , Uue         , Uue         , Uue         , Xuce        , Xuce        , Uue         , Wog         , Wog         , Uue         , Xuce        , Xuce        , Xuce        , Xuce        , Xuce        , Xuce        , Xuce        , Xuce        , Xuce        , Xuce        
Xuce        , Xuce        , Xuce        , Xuce        , Xuce        , Xuce        , Xuce        , Uue         , Wog         , Wog         , Uue         , Xuce        , Xuce        , Uue         , Uue         , Wog         , Wog         , Uue         , Xuce        , Xuce        , Xuce        , Xuce        , Xuce        , Xuce        , Xuce        , Xuce        , Xuce        
Xuce        , Xuce        , Xuce        , Xuce        , Xuce        , Xuce        , Uue         , Uue         , Uue         , Uue         , Xuce        , Xuce        , Xuce        , Xuce        , Xuce        , Uue         , Wog         , Uue         , Uue         , Xuce        , Xuce        , Xuce        , Xuce        , Xuce        , Xuce        , Xuce        , Xuce        
Xuce        , Xuce        , Xuce        , Xuce        , Xuce        , Uue         , Uue         , Uue         , Uue         , Xuce        , Xuce        , Xuce        , Uue         , Xuce        , Xuce        , Uue         , Uue         , Wog         , Wog         , Uue         , Xuce        , Xuce        , Xuce        , Xuce        , Xuce        , Xuce        , Xuce        
Xuce        , Xuce        , Xuce        , Xuce        , Xuce        , Uue         , Cud         , Uue         , Xuce        , Xuce        , Xuce        , Uue         , Cud         , Xue         , Xuce        , Xuce        , Cud         , Uue         , Uue         , Uue         , Xuce        , Xuce        , Xuce        , Xuce        , Xuce        , Xuce        , Xuce        
Xuce        , Xuce        , Xuce        , Xuce        , Xuce        , Uue         , Uue         , Uue         , Xuce        , Xuce        , Uue         , Uue         , Uue         , Uue         , Xuce        , Xuce        , Xuce        , Xuce        , Xuce        , Xuce        , Xuce        , Xuce        , Xuce        , Xuce        , Xuce        , Xuce        , Xuce        
Xuce        , Xuce        , Xuce        , Xuce        , Uue         , Xuce        , Xuce        , Xuce        , Uue         , Uue         , Uue         , Uue         , Uue         , Uue         , Xuce        , Xuce        , Xuce        , Xuce        , Xuce        , Xuce        , Xuce        , Xuce        , Xuce        , Xuce        , Xuce        , Xuce        , Xuce        
Xuce        , Xuce        , Xuce        , Uue         , Uue         , Xuce        , Xuce        , Uue         , Uue         , Uue         , Uue         , Uue         , Xuce        , Xuce        , Xuce        , Xuce        , Xuce        , Xuce        , Xuce        , Xuce        , Xuce        , Xuce        , Xuce        , Xuce        , Xuce        , Xuce        , Xuce        
Xuce        , Xuce        , Uue         , Cud         , Uue         , Xuce        , Xuce        , Cud         , Uue         , Uue         , Xuce        , Xuce        , Xuce        , Xuce        , Xuce        , Xuce        , Xuce        , Xuce        , Xuce        , Xuce        , Uue         , Uue         , Uue         , Xuce        , Xuce        , Xuce        , Xuce        
Xuce        , Xuce        , Uue         , Uue         , Uue         , Xuce        , Xuce        , Xuce        , Xuce        , Xuce        , Xuce        , Xuce        , Xuce        , Xuce        , Xuce        , Xuce        , Xuce        , Xuce        , Xuce        , Qxe         , Uue         , Cud         , 3 Kud       , Xuce        , Xuce        , Xuce        , Xuce        
Xuce        , Xuce        , Uue         , Uue         , Uue         , Xuce        , Uue         , Xuce        , Xuce        , Xuce        , Uue         , Uue         , Uue         , Uue         , Uue         , Xuce        , Xuce        , Xuce        , Xuce        , Qxe         , Qxe         , Uue         , Qxe         , Xuce        , Xuce        , Xuce        , Xuce        
Xuce        , Xuce        , Xuce        , Uue         , Uue         , Uue         , Cud         , Uue         , Xuce        , Xuce        , Uue         , Uue         , Uue         , Uue         , Uue         , Xuce        , Uue         , Xuce        , Xuce        , Xuce        , Xuce        , Qxe         , Xuce        , Xuce        , Xuce        , Xuce        , Xuce        
Xuce        , Xuce        , Xuce        , Uue         , Uue         , Uue         , Uue         , Uue         , Xuce        , Xuce        , Uue         , Uue         , Uue         , Uue         , Uue         , Cud         , Uue         , Xuce        , Xuce        , Xuce        , Xuce        , Xuce        , Xuce        , Xuce        , Xuce        , Xuce        , Xuce        
Xuce        , Xuce        , Xuce        , Xuce        , Xuce        , Uue         , Uue         , Uue         , Xuce        , Xuce        , Xuce        , Cud         , Xuce        , Uue         , Uue         , Uue         , Xuce        , Xuce        , Xuce        , Xuce        , Xuce        , Xuce        , Xuce        , Xuce        , Xuce        , Xuce        , Xuce        
Xuce        , Xuce        , Xuce        , Xuce        , Xuce        , Xuce        , Xuce        , Xuce        , Xuce        , Xuce        , Xuce        , Xuce        , Xuce        , Xuce        , Xuce        , Xuce        , Xuce        , Xuce        , Xuce        , Xuce        , Xuce        , Xuce        , Xuce        , Xuce        , Xuce        , Xuce        , Xuce        
Xuce        , Xuce        , Xuce        , Xuce        , Xuce        , Xuce        , Uue         , Xuce        , Xuce        , Xuce        , Xuce        , Xuce        , Xuce        , Xuce        , Xuce        , Xuce        , Xuce        , Xuce        , Xuce        , Xuce        , Xuce        , Xuce        , Xuce        , Xuce        , Xuce        , Xuce        , Xuce        
Xuce        , Xuce        , Xuce        , Xuce        , Xuce        , Uue         , Cud         , Uue         , Xuce        , Xuce        , Xuce        , Xuce        , Xuce        , Xuce        , Xuce        , Xuce        , Xuce        , Xuce        , Xuce        , Xuce        , Xuce        , Xuce        , Xuce        , Xuce        , Xuce        , Xuce        , Xuce        
Xuce        , Xuce        , Xuce        , Xuce        , Xuce        , Uue         , Uue         , Uue         , Uue         , Xuce        , Uue         , Xuce        , Xuce        , Xuce        , Xuce        , Xuce        , Xuce        , Xuce        , Xuce        , Xuce        , Xuce        , Xuce        , Xuce        , Xuce        , Xuce        , Xuce        , Xuce        
Xuce        , Xuce        , Xuce        , Xuce        , Xuce        , Uue         , Uue         , Uue         , Uue         , Uue         , Uue         , Uue         , Uue         , Xuce        , Xuce        , Xuce        , Xuce        , Xuce        , Xuce        , Xuce        , Xuce        , Xuce        , Xuce        , Xuce        , Xuce        , Xuce        , Xuce        
Xuce        , Xuce        , Xuce        , Xuce        , Xuce        , Xuce        , Xue         , Uue         , Uue         , Uue         , Uue         , Cud         , Uue         , Xuce        , Xuce        , Xuce        , Xuce        , Xuce        , Xuce        , Xuce        , Xuce        , Xuce        , Xuce        , Xuce        , Xuce        , Xuce        , Xuce        
Xuce        , Xuce        , Xuce        , Xuce        , Xuce        , Xuce        , Xuce        , Xue         , Xue         , Uue         , Xuce        , Uue         , Xuce        , Xuce        , Xuce        , Xuce        , Xuce        , Xuce        , Xuce        , Xuce        , Xuce        , Xuce        , Xuce        , Xuce        , Xuce        , Xuce        , Xuce        
Xuce        , Xuce        , Xuce        , Xuce        , Xuce        , Xuce        , Cud         , Xue         , Xue         , Xue         , Xuce        , Xuce        , Xuce        , Xuce        , Xuce        , Xuce        , Xuce        , Xuce        , Xuce        , Xuce        , Xuce        , Xuce        , Xuce        , Xuce        , Xuce        , Xuce        , Xuce        
Xuce        , Xuce        , Xuce        , Xuce        , Xuce        , Uue         , Uue         , Uue         , Uue         , Uue         , Uue         , Xuce        , Xuce        , Xuce        , Xuce        , Xuce        , Xuce        , Xuce        , Xuce        , Xuce        , Xuce        , Xuce        , Xuce        , Xuce        , Xuce        , Xuce        , Xuce        
Xuce        , Xuce        , Xuce        , Xuce        , Uue         , Uue         , Uue^Vct     , Uue         , Ce          , Ce          , Ce          , Uue         , Xuce        , Xuce        , Xuce        , Xuce        , Xuce        , Xuce        , Xuce        , Xuce        , Xuce        , Xuce        , Xuce        , Xuce        , Xuce        , Xuce        , Xuce        
Xuce        , Xuce        , Xuce        , Xuce        , Uue         , Uue^Vct     , Uue         , Uue         , Ce          , 1 Ke        , Uue         , Uue         , Xuce        , Xuce        , Xuce        , Xuce        , Xuce        , Xuce        , Xuce        , Xuce        , Xuce        , Xuce        , Xuce        , Xuce        , Xuce        , Xuce        , Xuce        
Xuce        , Xuce        , Xuce        , Xuce        , Xuce        , Uue         , Uue         , Uue         , Uue         , Uue         , Uue         , Uue         , Xuce        , Xuce        , Xuce        , Xuce        , Xuce        , Xuce        , Xuce        , Xuce        , Xuce        , Xuce        , Xuce        , Xuce        , Xuce        , Xuce        , Xuce        
