border_size=1
usage=map

Xue         , Xue         , Xue         , Xue         , Xue         , Xue         , Xue         , Xue         , Xue         , Xue         , Xue         , Xue         , Xue         , Xue         , Xue         , Xue         , Xue         , Xue         , Xue         , Xue         , Xue         , Xue         , Xue         , Xue         , Xue         , Xue         , Xue         
Xue         , Xue         , Uue         , Xue         , Uue         , Xue         , Xue         , Xue         , Xue         , Xue         , Xue         , Xue         , Xue         , Xue         , Xue         , Xue         , Xue         , Xue         , Xue         , Xue         , Xue         , Xue         , Xue         , Xue         , Xue         , Xue         , Xue         
Uue         , Uue         , Uue^Vu      , Uue         , Cud         , Uue         , Uue         , Uue         , Uue         , Xue         , Uue         , Cud         , Cud         , Xue         , Wog         , Xue         , Xue         , Xue         , Xue         , Xue         , Xue         , Xue         , Xue         , Xue         , Xue         , Xue         , Xue         
Uue         , Uue         , Uue         , Cud         , 2 Kud       , Cud         , Uue         , Uue^Vu      , Uue         , Uue         , Uue         , Cud         , Uue         , Wog         , Wog         , Xue         , Xue         , Xue         , Xue         , Xue         , Xue         , Xue         , Xue         , Xue         , Xue         , Xue         , Xue         
Uue         , Uue         , Uue         , Cud         , Cud         , Cud         , Uue         , Uue         , Uue         , Uue         , Cud         , Uue         , Uue         , Uue         , Uue         , Wog         , Xue         , Xue         , Xue         , Xue         , Xue         , Xue         , Xue         , Xue         , Xue         , Xue         , Xue         
Uue         , Uue         , Uue^Vu      , Uue         , Xue         , Uue         , Xue         , Uue         , Xue         , Cud         , Cud         , Uue         , Uue         , Uue         , Uue         , Xue         , Xue         , Xue         , Xue         , Xue         , Xue         , Xue         , Xue         , Xue         , Xue         , Xue         , Xue         
Xue         , Uue         , Xue         , Xue         , Xue         , Xue         , Xue         , Xue         , Xue         , Xue         , Wog         , Wog         , Uue         , Uue         , Uue         , Wog         , Wog         , Xue         , Xue         , Xue         , Xue         , Xue         , Xue         , Xue         , Xue         , Xue         , Xue         
Xue         , Xue         , Xue         , Xue         , Xue         , Xue         , Xue         , Xue         , Xue         , Xue         , Xue         , Wog         , Uue         , Uue         , Uue         , Uue         , Wog         , Xue         , Xue         , Xue         , Xue         , Xue         , Xue         , Xue         , Xue         , Xue         , Xue         
Xue         , Xue         , Xue         , Xue         , Xue         , Xue         , Xue         , Xue         , Xue         , Xue         , Xue         , Wog         , Wog         , Uue         , Uue         , Uue         , Uue         , Xue         , Wog         , Xue         , Xue         , Xue         , Xue         , Xue         , Xue         , Xue         , Xue         
Xue         , Xue         , Xue         , Xue         , Xue         , Xue         , Xue         , Xue         , Xue         , Xue         , Xue         , Wog         , Wog         , Uue         , Uue         , Uue         , Uue         , Uue         , Uue         , Wog         , Wog         , Xue         , Xue         , Xue         , Xue         , Xue         , Xue         
Xue         , Xue         , Xue         , Xue         , Xue         , Xue         , Xue         , Xue         , Xue         , Xue         , Xue         , Xue         , Xue         , Xue         , Wog         , Uue         , Uue         , Uue         , Uue         , Uue         , Wog         , Xue         , Xue         , Xue         , Xue         , Xue         , Xue         
Xue         , Xue         , Xue         , Xue         , Xue         , Xue         , Xue         , Xue         , Xue         , Xue         , Xue         , Xue         , Xue         , Xue         , Xue         , Wog         , Wog         , Uue         , Uue         , Uue         , Uue         , Xue         , Xue         , Xue         , Xue         , Xue         , Xue         
Xue         , Xue         , Xue         , Xue         , Xue         , Xue         , Xue         , Xue         , Xue         , Xue         , Xue         , Xue         , Xue         , Xue         , Xue         , Xue         , Xue         , Uue         , Uue         , Uue         , Uue         , Wog         , Wog         , Xue         , Xue         , Xue         , Xue         
Xue         , Xue         , Xue         , Xue         , Xue         , Xue         , Xue         , Xue         , Qxe         , Qxe         , Qxe         , Xue         , Xue         , Xue         , Xue         , Xue         , Xue         , Wog         , Uue         , Uue         , Uue         , Uue         , Wog         , Xue         , Xue         , Xue         , Xue         
Xue         , Xue         , Xue         , Xue         , Xue         , Xue         , Qxe         , Uue         , Urb         , Uue         , Uue         , Xue         , Xue         , Xue         , Xue         , Xue         , Xue         , Wog         , Wog         , Uue         , Uue         , Uue         , Wog         , Xue         , Xue         , Xue         , Xue         
Xue         , Xue         , Xue         , Xue         , Xue         , Qxe         , Uue         , Uue         , 3 Kud       , Cud         , Urb         , Qxe         , Qxe         , Xue         , Xue         , Xue         , Xue         , Xue         , Wog         , Uue         , Uue         , Wog         , Xue         , Xue         , Xue         , Xue         , Xue         
Xue         , Xue         , Xue         , Xue         , Qxe         , Uue         , Qxe         , Cud         , Cud         , Cud         , Uue         , Uue         , Qxe         , Xue         , Xue         , Xue         , Xue         , Xue         , Wog         , Uue         , Uue         , Wog         , Wog         , Xue         , Xue         , Xue         , Xue         
Xue         , Xue         , Xue         , Xue         , Qxe         , Uue         , Uue         , Qxe         , Uue         , Urb         , Uue         , Uue         , Xue         , Xue         , Xue         , Xue         , Xue         , Wog         , Wog         , Uue         , Uue         , Uue         , Wog         , Xue         , Xue         , Xue         , Xue         
Xue         , Xue         , Xue         , Xue         , Xue         , Qxe         , Uue         , Uue         , Xue         , Qxe         , Qxe         , Qxe         , Xue         , Xue         , Xue         , Xue         , Xue         , Wog         , Wog         , Uue         , Uue         , Uue         , Uue         , Wog         , Xue         , Xue         , Xue         
Xue         , Xue         , Xue         , Xue         , Xue         , Xue         , Xue         , Xue         , Xue         , Xue         , Xue         , Xue         , Xue         , Xue         , Xue         , Xue         , Xue         , Xue         , Xue         , Wog         , Uue         , Uue         , Uue         , Wog         , Xue         , Xue         , Xue         
Xue         , Xue         , Xue         , Xue         , Xue         , Xue         , Xue         , Xue         , Xue         , Xue         , Xue         , Xue         , Xue         , Xue         , Xue         , Xue         , Xue         , Xue         , Wog         , Wog         , Uue         , Uue         , Uue         , Wog         , Xue         , Xue         , Xue         
Xue         , Xue         , Xue         , Xue         , Xue         , Xue         , Xue         , Xue         , Xue         , Xue         , Xue         , Xue         , Xue         , Xue         , Xue         , Xue         , Xue         , Wog         , Wog         , Uue         , Uue         , Uue         , Wog         , Wog         , Xue         , Xue         , Xue         
Xue         , Xue         , Xue         , Xue         , Xue         , Xue         , Xue         , Xue         , Xue         , Xue         , Xue         , Xue         , Xue         , Xue         , Xue         , Xue         , Xue         , Wog         , Wog         , Uue         , Uue         , Uue         , Xue         , Xue         , Xue         , Xue         , Xue         
Xue         , Xue         , Xue         , Xue         , Xue         , Xue         , Xue         , Xue         , Xue         , Xue         , Xue         , Xue         , Xue         , Xue         , Xue         , Xue         , Xue         , Xue         , Uue         , Uue         , Uue         , Uue         , Xue         , Xue         , Xue         , Xue         , Xue         
Xue         , Xue         , Xue         , Xue         , Xue         , Xue         , Xue         , Xue         , Xue         , Xue         , Xue         , Xue         , Xue         , Xue         , Xue         , Xue         , Xue         , Xue         , Uue         , Uue         , Uue         , Xue         , Xue         , Xue         , Xue         , Xue         , Xue         
Xue         , Xue         , Xue         , Xue         , Xue         , Xue         , Xue         , Xue         , Xue         , Xue         , Xue         , Xue         , Xue         , Xue         , Xue         , Xue         , Wog         , Wog         , Uue         , Uue         , Uue         , Xue         , Xue         , Xue         , Xue         , Xue         , Xue         
Xue         , Xue         , Xue         , Xue         , Xue         , Xue         , Xue         , Xue         , Xue         , Xue         , Xue         , Xue         , Xue         , Xue         , Xue         , Xue         , Wog         , Uue         , Uue         , Uue         , Uue         , Wog         , Xue         , Xue         , Xue         , Xue         , Xue         
Xue         , Xue         , Xue         , Xue         , Xue         , Xue         , Xue         , Xue         , Xue         , Xue         , Xue         , Xue         , Xue         , Xue         , Xue         , Wog         , Uue         , Uue         , Uue         , Uue         , Wog         , Wog         , Xue         , Xue         , Xue         , Xue         , Xue         
Xue         , Xue         , Xue         , Xue         , Xue         , Xue         , Xue         , Xue         , Xue         , Xue         , Xue         , Xue         , Uue         , Xue         , Xue         , Xue         , Uue         , Uue         , Uue         , Uue         , Wog         , Xue         , Xue         , Xue         , Xue         , Xue         , Xue         
Xue         , Xue         , Xue         , Xue         , Xue         , Xue         , Xue         , Xue         , Xue         , Xue         , Uue         , Uue         , Uue^Vct     , Uue         , Uue         , Uue         , Uue         , Uue         , Xue         , Xue         , Xue         , Xue         , Xue         , Xue         , Xue         , Xue         , Xue         
Xue         , Xue         , Xue         , Xue         , Xue         , Xue         , Xue         , Xue         , Xue         , Uue         , Uue         , Uue         , Uue         , Uue         , Ce          , Uue         , Uue         , Uue         , Uue         , Xue         , Xue         , Xue         , Xue         , Xue         , Xue         , Xue         , Xue         
Xue         , Xue         , Xue         , Xue         , Xue         , Xue         , Xue         , Xue         , Xue         , Uue         , Uue         , Uue^Vct     , Uue         , Ce          , 1 Ke        , Ce          , Uue         , Uue         , Uue         , Xue         , Xue         , Xue         , Xue         , Xue         , Xue         , Xue         , Xue         
Xue         , Xue         , Xue         , Xue         , Xue         , Xue         , Xue         , Xue         , Xue         , Xue         , Uue         , Uue         , Uue         , Ce          , Ce          , Ce          , Uue         , Uue         , Xue         , Xue         , Xue         , Xue         , Xue         , Xue         , Xue         , Xue         , Xue         
Xue         , Xue         , Xue         , Xue         , Xue         , Xue         , Xue         , Xue         , Xue         , Xue         , Xue         , Uue         , Uue         , Uue         , Uue         , Uue         , Uue         , Uue         , Xue         , Xue         , Xue         , Xue         , Xue         , Xue         , Xue         , Xue         , Xue         
Xue         , Xue         , Xue         , Xue         , Xue         , Xue         , Xue         , Xue         , Xue         , Xue         , Xue         , Uue         , Uue         , Uue         , Uue         , Uue         , Uue         , Xue         , Xue         , Xue         , Xue         , Xue         , Xue         , Xue         , Xue         , Xue         , Xue         
