border_size=1
usage=map

Xue         , Xue         , Xue         , Xue         , Xue         , Xue         , Xue         , Xue         , Xue         , Xue         , Xue         , Xue         , Xue         , Xue         , Xue         , Xue         , Xue         , Xue         , Xue         , Xue         , Xue         , Mm^Xm       , Mm          , Mm          , Hh          , Gs^Ft       , Gs^Ft       , Gs^Ft       , Gs^Ft       , Gs          , Gs          , Dd          , Dd          , Dd          , Dd^Edp      , Dd          , Dd          , Dd          , Dd          , Dd          , Dd          , Dd          , Dd^Edp      , Dd          , Dd^Edp      , Dd          , Dd          , Dd          , Dd          , Dd          
Xue         , Xue         , Xue         , Xue         , Xue         , Xue         , Xue         , Xue         , Xue         , Xue         , Xue         , Xue         , Xue         , Xue         , Xue         , Xue         , Xue         , Xue         , Xue         , Xue         , Mm^Xm       , Mm^Xm       , Mm          , Mm          , Hh          , Gs          , Gs          , Gs          , Gs          , Gs          , Gs^Ft       , Gs          , Gs          , Dd^Edp      , Dd          , Dd^Edp      , Dd          , Dd          , Dd          , Dd          , Dd          , Dd          , Dd          , Dd          , Dd          , Dd          , Dd          , Dd          , Dd          , Dd          
Xue         , Xue         , Xue         , Xue         , Xue         , Xue         , Xue         , Xue         , Uue         , Xue         , Uue         , Xue         , Xue         , Xue         , Xue         , Xue         , Xue         , Xue         , Xue         , Xue         , Mm^Xm       , Mm^Xm       , Mm          , Hh          , Gs^Ft       , Gs^Ft       , Gs          , Gd          , Gd          , Gs^Ft       , Gs^Ft       , Gs          , Gs          , Dd^Edp      , Dd          , Dd          , Dd          , Dd          , Dd          , Dd          , Dd          , Dd          , Dd          , Dd          , Dd          , Dd          , Dd^Edp      , Dd          , Dd          , Dd          
Xue         , Xue         , Xue         , Xue         , Xue         , Xue         , Uue^Uf      , Uue         , Uue         , Uue         , Uue^Ii      , Uue         , Uue^Ii      , Uue         , Uue         , Xue         , Uue^Uf      , Xue         , Xue         , Xue         , Mm^Xm       , Mm^Xm       , Mm          , Hh          , Gs          , Gs          , Gs^Ft       , Gs^Ft       , Gs^Ft       , Gs          , Gs          , Gs          , Gs          , Dd          , Dd          , Dd          , Dd^Edp      , Dd          , Dd          , Dd^Edp      , Dd^Edp      , Dd          , Dd          , Dd          , Dd          , Dd          , Dd          , Dd          , Dd          , Dd          
Xue         , Xue         , Xue         , Xue         , Xue         , Xue         , Uue^Uf      , Uue^Uf      , Uue         , Uue^Ii      , Uue         , Uue^Ii      , Uue^Uf      , Uue         , Uue         , Uue^Uf      , Uue^Ii      , Uue^Ii      , Uue^Ii      , Mm^Xm       , Mm          , Mm          , Hh          , Hh          , Gs^Ft       , Gd          , Gd          , Gs^Emf      , Gs          , Gs          , Gs^Emf      , Gs          , Dd          , Dd          , Dd          , Dd          , Dd          , Dd          , Dd          , Dd          , Dd          , Dd          , Dd^Edp      , Dd          , Dd^Edp      , Dd          , Dd          , Dd          , Dd^Edp      , Dd          
Xue         , Xue         , Xue         , Xue         , Uue         , Uue         , Uue         , Uue         , Uue         , Uue         , Uue         , Uue         , Uue^Uf      , Uue^Uf      , Uue         , Uue^Ii      , Uue^Ii      , Uue         , Uue^Uf      , Uue^Uf      , Hhd         , Hh          , Gs          , Gs          , Gs^Ft       , Gs          , Gs          , Gs          , Gs          , Gs^Ft       , Gs^Ft       , Gs          , Dd          , Dd          , Dd          , Dd          , Dd          , Dd          , Dd          , Dd          , Dd          , Dd^Edp      , Dd          , Dd          , Dd          , Dd          , Dd          , Dd          , Dd          , Dd          
Xue         , Xue         , Uue^Uf      , Uue         , Uue         , Uue         , Uue         , Uue         , Uue         , Uue^Ii      , Uue^Ii      , Uue^Ii      , Uue^Ii      , Uue^Ii      , Uue         , Uue^Uf      , Uue^Uf      , Uue^Ii      , Uue         , Uue         , Hhd         , Hh          , Gs          , Gs^Ft       , Gs          , Gs          , Gs^Emf      , Gs          , Gs          , Gs^Ft       , Gs          , Gs          , Gs          , Dd          , Dd          , Dd          , Dd          , Dd^Edp      , Dd          , Dd          , Dd          , Dd          , Dd^Edp      , Dd          , Dd          , Dd          , Dd^Edp      , Dd          , Dd^Edp      , Dd          
Uue^Uf      , Uue^Uf      , Uue^Uf      , Uue         , Uue^Uf      , Uue^Uf      , Uue^Uf      , Uue         , Uue^Uf      , Uue^Uf      , Uue^Ii      , Uue         , Uue         , Uue         , Uue         , Uue^Uf      , Uue^Ii      , Uue         , Uue         , Hhd         , Mm          , Hh          , Hh          , Gs^Ft       , Gs          , Gs^Ft       , Gs^Ft       , Gs^Ft       , Gs          , Gs          , Gs^Ft       , Gs          , Gs          , Dd          , Dd          , Dd          , Dd          , Dd^Edp      , Dd          , Dd          , Dd^Edp      , Dd          , Dd          , Dd          , Dd          , Dd^Edp      , Dd^Edp      , Dd          , Dd^Edp      , Dd^Edp      
Uue         , Uue         , 1 Uue       , Uue         , Uue         , Uue^Uf      , Uue         , Uue         , Uue         , Uue^Uf      , Xue         , Uue         , Uue^Uf      , Uue         , Uue^Ii      , Uue^Ii      , Uue^Uf      , Uue^Ii      , Xue         , Mm^Xm       , Mm^Xm       , Mm          , Hh          , Gs^Ft       , Hh          , Gd          , Gd          , Gd          , Gs          , Gs^Ft       , Gs^Ft       , Gs^Emf      , Gs          , Dd^Edp      , Dd          , Dd          , Dd          , Dd          , Dd^Edp      , Dd          , Dd^Edp      , Dd          , Dd          , Dd          , Dd^Edp      , Dd          , Dd^Edp      , Dd^Edp      , Dd          , Dd          
Uue^Uf      , Uue         , Uue         , Uue         , Xue         , Xue         , Xue         , Uue         , Xue         , Xue         , Xue         , Xue         , Xue         , Uue^Uf      , Xue         , Uue^Uf      , Xue         , Xue         , Xue         , Xue         , Mm^Xm       , Mm^Xm       , Mm          , Hh          , Mm          , Hh          , Gs          , Gs          , Gs^Ft       , Gs          , Gs          , Gs          , Gs          , Gs          , Dd          , Dd^Edp      , Dd          , Dd          , Dd          , Dd          , Dd          , Dd          , Dd          , Dd          , Dd          , Dd          , Dd          , Dd          , Dd^Edp      , Dd^Edp      
Xue         , Uue^Uf      , Xue         , Xue         , Xue         , Xue         , Xue         , Xue         , Xue         , Xue         , Xue         , Xue         , Xue         , Xue         , Xue         , Xue         , Xue         , Xue         , Xue         , Xue         , Mm^Xm       , Mm          , Mm          , Mm          , Mm          , Hh          , Gs          , Gs^Ft       , Gs^Ft       , Gd          , Gs          , Gs          , Gs          , Dd          , Dd          , Dd          , Dd          , Dd          , Dd^Edp      , Dd          , Dd          , Dd^Edp      , Dd          , Dd          , Dd          , Dd          , Dd          , Dd          , Dd          , Dd          
Xue         , Xue         , Xue         , Xue         , Xue         , Xue         , Xue         , Xue         , Xue         , Xue         , Xue         , Xue         , Xue         , Xue         , Xue         , Xue         , Xue         , Xue         , Xue         , Xue         , Mm^Xm       , Mm^Xm       , Mm          , Mm          , Hh          , Hh          , Gs          , Gs^Emf      , Gs^Emf      , Gs^Ft       , Gs          , Gs          , Gs          , Dd          , Dd          , Dd          , Dd          , Dd          , Dd          , Dd          , Dd          , Dd          , Dd          , Dd          , Dd^Edp      , Dd          , Dd^Edp      , Dd^Edp      , Dd          , Dd          
