border_size=1
usage=map

Gs^Ft       , Gs          , Dd          , Ds          , Ds          , Ds          , Ds          , Ds          , Ds          , Ds          , Ds          , Ds          , Dd          , Dd          , Dd          , Ds          , Ds          , Ds          , Ds          , Ds          , Ds          , Ds          , Dd          , Dd          , Dd          , Dd          , Dd          , Ds          , Ds          , Ds          , Ds          , Ds          , Ds          , Ds          , Ds          , Ds          
Dd          , Gs          , Dd          , Ds          , Ds          , Ds          , Ds          , Ds          , Ds          , Ds          , Ds          , Ds          , Ds          , Ds          , Ds          , Ds          , Ds          , Ds          , Ds          , Ds          , Ds          , Ds          , Ds          , Ds          , Ds          , Ds          , Ds          , Ds          , Ds          , Ds          , Ds          , Ds          , Ds          , Ds          , Ds          , Ds          
Gs          , Gs          , Dd          , Ds          , Ds          , Ds          , Ds          , Dd          , Dd          , Dd          , Ds          , Ds          , Ds          , Ds          , Ds          , Ds          , Ds          , Ds          , Ds          , Ds          , Ds          , Ds          , Ds          , Ds          , Ds          , Ds          , Ds          , Ds          , Ds          , Ds          , Ce          , Ds          , Ds          , Ds          , Ds          , Ds          
Gs          , Gs          , Dd          , Ds          , Ce          , Ce          , Ce          , Dd          , Dd^Vda      , Dd          , Ds          , Ds          , Ds          , Ds          , Ds          , Ds          , Ds          , Ds          , Ds          , Ds          , Ds          , Ds          , Ds          , Ds          , Ds          , Ds          , Ds          , Ds          , Ds          , Ds          , 4 Ke        , Ds          , Ds          , Ds          , Ds          , Ds          
Dd          , Dd          , Ds          , Ds          , Ce          , 1 Ke        , Ce          , Dd          , Dd          , Dd          , Ds          , Ds          , Ds          , Ds          , Ds          , Ds          , Ds          , Ds          , Ds          , Ds          , Ds          , Ds          , Ds          , Ds          , Ds          , Ds          , Ds          , Ds          , Ds          , Ce          , Ce          , Ce          , Ds          , Ds          , Ds          , Ds          
Dd          , Dd          , Gs          , Dd          , Dd          , Dd          , Dd          , Ds          , Ds          , Ds          , Ds          , Ds          , Ds          , Ds          , Ds          , Ds          , Ds          , Ds          , Ds          , Ds          , Ds          , Ds          , Ds          , Ds          , Ds          , Ds          , Ds          , Ds          , Ds          , Ds          , Ds          , Ds          , Ds          , Ds          , Ds          , Ds          
Gs          , Gs          , Gs          , Dd          , Ds          , Ds          , Ds          , Ds          , Ds          , Ds          , Ds          , Ds          , Ds          , Ds          , Ds          , Ds          , Ds          , Ds          , Ds          , Ds          , Ds          , Ds          , Ds          , Ds          , Ds          , Ds          , Ds          , Ds          , Ds          , Ds          , Ds          , Ds          , Ds          , Ds          , Ds          , Ds          
Gs          , Gs          , Gs          , Dd          , Ds          , Ds          , Ds          , Ds          , Ds          , Ds          , Ds          , Ds          , Ds          , Ds          , Ds          , Ds          , Ds          , Dd          , Dd^Vda      , Dd          , Dd          , Dd          , Ds          , Ds          , Ds          , Ds          , Ds          , Ds          , Ds          , Ds          , Ds          , Ds          , Ds          , Ds          , Ds          , Ds          
Dd          , Gs          , Dd          , Ds          , Ds          , Ds          , Ds          , Ds          , Ds          , Ds          , Ds          , Ds          , Ds          , Ds          , Ds          , Ds          , Ds          , Dd          , Gs          , Gs          , Gs          , Gs^Vht      , Dd          , Ds          , Ds          , Ds          , Ds          , Ds          , Ds          , Ds          , Ds          , Ds          , Ds          , Ds          , Ds          , Ds          
Dd          , Gs          , Dd          , Ds          , Ds          , Ds          , Ds          , Ds          , Ds          , Dd          , Dd          , Dd          , Dd          , Dd          , Ds          , Ds          , Ds          , Gs          , Hd          , Md          , Hd          , Hd          , Gs          , Gs^Ft       , Ds          , Ds          , Ds          , Ds          , Ds          , Ds          , Dd          , Dd          , Dd          , Dd          , Dd          , Ds          
Dd          , Dd          , Ds          , Ds          , Ds          , Ds          , Ds          , Ds          , Dd          , Gs^Ft       , Dd          , Dd          , Dd          , Dd          , Dd          , Ds          , Ds          , Gs          , Hd          , Md          , Md          , Md          , Hd          , Gs          , Ds          , Ds          , Ds          , Ds          , Ds          , Ds          , Dd          , Gs^Ft       , Gs^Ft       , Dd          , Dd          , Ds          
Dd          , Dd          , Dd          , Dd          , Ds          , Ds          , Ds          , Ds          , Gs          , Gs^Ft       , Hd          , Hd          , Hd          , Dd          , Dd          , Ds          , Ds          , Gs          , Gs          , Hd          , Md          , Md          , Gs          , Gs          , Ds          , Ds          , Ds          , Ds          , Ds          , Ds          , Dd          , Dd          , Dd          , Dd          , Dd          , Ds          
Dd          , Gs^Ft       , Gs^Ft       , Dd          , Ds          , Ds          , Ds          , Dd          , Gs          , Hd          , Md          , Md          , Md          , Dd          , Dd          , Ds          , Ds          , Dd          , Gs          , Gs          , Gs          , Gs          , Gs          , Dd          , Ds          , Ds          , Ds          , Ds          , Ds          , Ds          , Dd          , Dd^Vda      , Gs^Ft       , Dd          , Dd          , Ds          
Gs^Ft       , Gs^Vht      , Gs^Ft       , Dd          , Ds          , Ds          , Ds          , Dd^Vda      , Gs^Ft       , Md          , Md          , Md          , Md          , Dd          , Dd          , Ds          , Ds          , Dd          , Gs          , Gs          , Gs          , Gs          , Gs          , Gs^Ft       , Ds          , Ds          , Ds          , Ds          , Ds          , Dd          , Dd          , Dd          , Gs^Ft       , Gs^Ft       , Dd          , Ds          
Gs          , Gs          , Gs          , Dd          , Ds          , Ds          , Ds          , Dd          , Gs^Ft       , Md          , Md          , Md          , Hd          , Gs          , Gs          , Dd          , Dd          , Dd          , Gs          , Gs          , Gs^Ft       , Gs^Ft       , Dd          , Dd          , Ds          , Ds          , Ds          , Ds          , Dd          , Dd          , Gs^Ft       , Gs          , Gs          , Dd          , Ds          , Ds          
Dd          , Dd          , Dd          , Dd          , Ds          , Ds          , Ds          , Dd          , Dd          , Hd          , Hd          , Hd          , Gs          , Gg^Vh       , Gs          , Gs          , Gs          , Gs          , Gs          , Gs^Ft       , Dd          , Dd          , Dd^Vda      , Dd          , Ds          , Ds          , Ds          , Ds          , Dd          , Gs^Ft       , Hd          , Md          , Gs          , Dd          , Ds          , Ds          
Ds          , Ds          , Ds          , Ds          , Ds          , Dd          , Dd          , Gs          , Gs^Ft       , Dd          , Dd          , Gs^Ft       , Gs          , Gs          , Gs          , Gs          , Gs          , Gs          , Dd          , Dd          , Dd          , Dd          , Dd          , Dd          , Ds          , Ds          , Ds          , Ds          , Dd          , Gs^Ft       , Md          , Md          , Hd          , Dd          , Ds          , Ds          
Ds          , Ds          , Ds          , Ds          , Ds          , Dd          , Gs          , Gs          , Gs          , Dd          , Dd          , Dd          , Gs^Ft       , Gs          , Gs^Ft       , Gs^Ft       , Hd          , Dd          , Dd          , Dd          , Dd          , Dd          , Dd          , Dd          , Ds          , Ds          , Ds          , Ds          , Hd          , Md          , Md          , Md          , Gs          , Dd          , Ds          , Ds          
Ds          , Ds          , Ds          , Ds          , Ds          , Dd          , Dd          , Gs          , Ds          , Dd          , Dd          , Dd          , Dd          , Gs^Ft       , Dd          , Dd          , Dd          , Dd          , Dd          , Dd          , Ds          , Ds          , Ds          , Ds          , Ds          , Ds          , Ds          , Ds          , Hd          , Md          , Hd          , Gs          , Gs          , Ds          , Ds          , Ds          
Ds          , Ds          , Ds          , Ds          , Ds          , Ds          , Ds          , Ds          , Ds          , Dd          , Dd          , Dd          , Dd          , Gs^Ft       , Dd          , Dd          , Dd          , Dd          , Dd          , Dd          , Ds          , Dd          , Ds          , Ds          , Ds          , Ds          , Ds          , Ds          , Dd          , Dd          , Dd          , Ds          , Ds          , Ds          , Ds          , Ds          
Ds          , Ds          , Ds          , Cd          , Cd          , Cd          , Ds          , Ds          , Ds          , Dd          , Dd          , Dd          , Dd          , Dd          , Dd          , Dd          , Dd          , Dd          , Dd          , Ds          , Ds          , Ds          , Ds          , Ds          , Ds          , Ds          , Ds          , Ds          , Dd          , Dd^Vda      , Dd          , Ds          , Ds          , Ds          , Ds          , Ds          
Ds          , Ds          , Ds          , Cd          , 3 Kd        , Cd          , Dd          , Dd          , Dd          , Dd^Vda      , Dd          , Ds          , Ds          , Ds          , Ds          , Ds          , Ds          , Ds          , Ds          , Ds          , Ds          , Ds          , Ds          , Ds          , Ds          , Ds          , Ds          , Ds          , Ds          , Ds          , Ds          , Ds          , Ds          , Ds          , Ds          , Ds          
Ds          , Ds          , Ds          , Dd          , Dd          , Gs          , Gs          , Gs          , Gs          , Dd          , Dd          , Dd          , Ds          , Ds          , Ds          , Ds          , Ds          , Ds          , Ds          , Ds          , Ds          , Ds          , Ds          , Ds          , Ds          , Ds          , Ds          , Ds          , Ds          , Ds          , Ds          , Ds          , Ds          , Ds          , Ds          , Ds          
Ds          , Ds          , Ds          , Ds          , Ds          , Dd          , Gs          , Gs          , Gs          , Dd          , Dd          , Dd          , Ds          , Ds          , Ds          , Ds          , Ds          , Ds          , Ds          , Ds          , Ds          , Ds          , Ds          , Ds          , Dd^Vda      , Ds          , Ds          , Ds          , Ds          , Ds          , Ds          , Ds          , Dd          , Dd          , Dd          , Dd          
Ds          , Ds          , Ds          , Ds          , Ds          , Dd          , Gs          , Gs          , Hd          , Dd          , Dd          , Dd          , Ds          , Ds          , Ds          , Ds          , Ds          , Ds          , Ds          , Ds          , Ds          , Ds          , Ds          , Ds          , Ds          , Ds          , Ds          , Ds          , Dd          , Dd          , Dd          , Dd          , Gs          , Gs          , Gs^Ft       , Gs^Ft       
Ds          , Ds          , Ds          , Ds          , Ds          , Dd          , Gs          , Gs          , Gs^Ft       , Dd          , Dd          , Dd          , Ds          , Ds          , Ds          , Ds          , Ds          , Ds          , Dd          , Dd          , Dd          , Dd          , Dd          , Ds          , Ds          , Ds          , Ds          , Ds          , Dd          , Hd          , Hd          , Hd          , Hd          , Hd          , Hd          , Dd          
Ds          , Ds          , Ds          , Ds          , Ds          , Dd          , Gs          , Gs          , Dd          , Dd          , Gs          , Dd          , Ds          , Ds          , Ds          , Ds          , Ds          , Ds          , Dd^Vda      , Gs^Ft       , Gs^Ft       , Dd          , Dd          , Ds          , Ds          , Ds          , Ds          , Ds          , Dd          , Hd          , Md          , Md          , Md          , Hd          , Dd          , Dd          
Ds          , Ds          , Ds          , Ds          , Ds          , Ds          , Dd          , Dd^Vda      , Dd          , Dd          , Dd          , Ds          , Ds          , Ds          , Ds          , Ds          , Ds          , Ds          , Dd          , Gs^Ft       , Cd          , Cd          , Cd          , Ds          , Ds          , Ds          , Ds          , Ds          , Dd          , Hd          , Md          , Md          , Md          , Dd          , Dd          , Dd          
Dd          , Ds          , Ds          , Ds          , Ds          , Ds          , Ds          , Ds          , Ds          , Ds          , Ds          , Ds          , Ds          , Ds          , Ds          , Ds          , Ds          , Ds          , Dd          , Gs^Ft       , Cd          , 2 Kd        , Cd          , Ds          , Ds          , Ds          , Ds          , Ds          , Dd          , Dd^Vda      , Hd          , Hd          , Hd          , Dd          , Dd          , Ds          
Dd          , Ds          , Ds          , Ds          , Ds          , Ds          , Ds          , Ds          , Ds          , Ds          , Ds          , Ds          , Ds          , Ds          , Ds          , Ds          , Ds          , Ds          , Dd          , Dd          , Dd          , Dd          , Dd          , Ds          , Ds          , Dd          , Dd          , Dd          , Dd          , Dd          , Dd          , Gs          , Gs          , Hd          , Dd          , Ds          
Dd          , Ds          , Ds          , Ds          , Ds          , Ds          , Ds          , Ds          , Ds          , Ds          , Ds          , Ds          , Ds          , Ds          , Ds          , Ds          , Ds          , Ds          , Ds          , Ds          , Ds          , Ds          , Dd          , Dd          , Gs          , Gs          , Gs          , Gs          , Gs^Ft       , Dd          , Dd          , Dd          , Dd          , Dd          , Dd          , Dd          
Ds          , Ds          , Ds          , Ds          , Dd          , Ds          , Ds          , Ds          , Ds          , Ds          , Ds          , Ds          , Ds          , Ds          , Ds          , Ds          , Ds          , Ds          , Ds          , Ds          , Ds          , Dd          , Gs          , Gs          , Gs          , Hd          , Md          , Hd          , Gs          , Gs^Ft       , Dd          , Ds          , Ds          , Dd          , Dd          , Dd          
Ds          , Ds          , Ds          , Ds          , Ds          , Ds          , Ds          , Ds          , Ds          , Ds          , Ds          , Ds          , Ds          , Ds          , Ds          , Ds          , Ds          , Ds          , Ds          , Ds          , Ds          , Dd          , Gs          , Gg^Vh       , Hd          , Md          , Md          , Md          , Dd          , Gs^Ft       , Dd          , Ds          , Ds          , Dd          , Dd          , Dd          
Ds          , Ds          , Ds          , Ds          , Ds          , Ds          , Ds          , Ds          , Ds          , Ds          , Ds          , Ds          , Ds          , Ds          , Ds          , Ds          , Ds          , Ds          , Ds          , Ds          , Ds          , Dd          , Gs          , Gs          , Md          , Md          , Md          , Hd          , Dd          , Dd          , Dd          , Ds          , Ds          , Ds          , Ds          , Ds          
