border_size=1
usage=map

Dd          , Dd          , Dd          , Dd          , Dd          , Dd          , Dd          , Dd          , Dd          , Dd          , Dd^Edpp     , Dd          , Dd          , Dd          , Dd^Edp      , Dd          , Dd          , Dd          , Dd          , Dd          , Dd          , Dd          , Dd^Edpp     , Dd          , Dd          , Dd          , Dd          , Dd          , Dd          , Dd          , Dd          , Dd          , Dd          , Dd          , Dd          
Dd          , Dd          , Dd          , Dd^Edpp     , Dd          , Dd          , Dd          , Dd          , Dd          , Dd          , Dd          , Dd          , Dd          , Dd          , Dd          , Dd          , Dd          , Dd          , Dd          , Dd          , Dd          , Dd          , Dd          , Dd          , Dd          , Dd          , Dd          , Dd          , Dd          , Dd          , Dd          , Dd          , Dd          , Dd          , Dd          
Dd          , Dd          , Dd          , Dd          , Dd          , Dd^Vdt      , Dd          , Dd          , Dd^Edp      , Dd          , Dd^Es       , Dd^Es       , Dd          , Dd          , Dd^Edpp     , Dd          , Dd          , Dd          , Dd^Es       , Dd          , Dd          , Dd          , Dd          , Dd          , Dd          , Dd          , Dd          , Dd          , Dd          , Dd          , Dd          , Dd          , Dd          , Dd          , Dd          
Dd          , Dd          , Dd          , Dd^Vdt      , Dd          , Dd          , Ce          , Ce          , Ce          , Dd          , Dd^Edpp     , Dd          , Dd          , Dd          , Dd          , Dd          , Dd          , Dd          , Dd          , Dd          , Dd          , Dd          , Dd          , Dd          , Dd          , Dd          , Dd^Edp      , Dd          , Dd          , Dd          , Dd          , Dd^Edp      , Dd          , Dd          , Dd          
Dd          , Dd          , Dd^Esd      , Dd          , Ce          , Ce          , 1 Ke        , Ce          , Ce          , Dd^Es       , Dd          , Dd          , Ce          , Ce          , Ce          , Ce          , Ce          , Dd          , Dd          , Dd          , Dd          , Dd          , Dd          , Dd          , Dd          , Dd          , Dd          , Dd          , Dd^Edp      , Dd          , Dd          , Dd          , Dd          , Dd          , Dd          
Dd          , Dd          , Dd^Vdt      , Dd          , Ce          , Ce          , Ce          , Ce          , Dd          , Dd          , Dd          , Dd          , Dd^Vdt      , Dd^Vdt      , Ce          , Dd^Vdt      , Dd^Vdt      , Dd          , Dd          , Dd          , Dd          , Dd          , Dd^Edpp     , Dd          , Dd          , Dd          , Dd          , Dd          , Dd          , Dd          , Dd          , Dd          , Dd          , Dd^Es       , Dd^Esd      
Dd          , Dd^Esd      , Dd          , Dd          , Dd          , Ce          , Dd          , Dd          , Dd          , Dd^Vdt      , Dd          , Ce          , Dd^Vdt      , Ce          , 2 Ke        , Ce          , Dd^Vdt      , Ce          , Dd          , Dd          , Dd          , Dd          , Dd          , Dd          , Dd          , Dd          , Dd          , Dd          , Dd          , Dd          , Dd          , Dd          , Dd          , Dd          , Dd          
Dd          , Dd          , Dd          , Dd^Vdt      , Dd          , Dd          , Dd          , Dd^Vdt      , Dd          , Dd          , Dd          , Ce          , Ce          , Ce          , Ce          , Ce          , Ce          , Ce          , Dd          , Dd          , Dd          , Dd          , Dd          , Dd          , Dd          , Dd          , Dd^Edpp     , Dd          , Dd          , Dd          , Dd          , Dd          , Dd          , Dd          , Dd          
Dd          , Dd          , Dd          , Dd          , Dd          , Dd^Esd      , Dd          , Dd          , Dd          , Dd          , Dd          , Dd          , Ce          , Dd^Vdt      , Dd^Vdt      , Dd^Vdt      , Ce          , Dd          , Dd          , Dd          , Dd          , Dd          , Dd          , Dd          , Dd          , Dd          , Dd^Esd      , Dd          , Dd          , Dd          , Dd          , Dd          , Dd          , Dd          , Dd          
Dd          , Dd          , Dd          , Dd          , Dd          , Dd          , Dd          , Dd^Edp      , Dd          , Dd          , Dd          , Dd          , Dd          , Ce          , Dd          , Ce          , Dd          , Dd          , Dd          , Dd          , Dd          , Dd          , Dd          , Dd          , Dd          , Dd          , Dd          , Dd          , Dd          , Dd          , Dd          , Dd          , Dd          , Dd          , Dd          
Dd          , Dd          , Dd          , Dd          , Dd          , Dd          , Dd          , Dd          , Dd          , Dd          , Dd^Edpp     , Dd          , Dd          , Dd          , Dd          , Dd          , Dd          , Dd          , Dd          , Dd          , Dd          , Dd          , Dd          , Dd          , Dd          , Dd          , Dd^Es       , Dd          , Dd          , Dd          , Dd          , Dd          , Dd          , Dd          , Dd          
Dd          , Dd          , Dd          , Dd          , Dd          , Dd          , Dd          , Dd          , Dd^Edp      , Dd          , Dd^Edp      , Dd          , Dd          , Dd          , Dd          , Dd          , Dd^Edpp     , Dd          , Dd          , Dd          , Dd          , Dd          , Dd          , Dd          , Dd          , Dd          , Dd          , Dd          , Dd          , Dd          , Dd          , Dd          , Dd          , Dd^Es       , Dd          
Dd          , Dd          , Dd          , Dd          , Dd          , Dd          , Dd          , Dd          , Dd          , Dd          , Dd          , Dd          , Dd          , Dd          , Dd          , Dd          , Dd          , Dd          , Dd          , Dd^Edpp     , Dd          , Dd          , Dd          , Dd          , Dd          , Dd          , Dd          , Dd          , Dd          , Dd          , Dd          , Dd          , Dd          , Dd          , Dd          
Dd          , Dd          , Dd          , Dd          , Dd          , Dd          , Dd          , Dd          , Dd          , Dd          , Dd          , Dd          , Hhd         , Dd          , Dd^Es       , Dd          , Dd          , Dd          , Dd          , Dd          , Dd          , Dd          , Dd          , Dd^Esd      , Dd          , Dd          , Dd          , Dd          , Hd          , Dd          , Hhd         , Dd          , Hd          , Hd          , Hd          
Dd          , Dd          , Dd          , Dd          , Hd          , Hd          , Hhd         , Hhd         , Hhd         , Hd          , Hd          , Hhd         , Md          , Hhd         , Hd          , Dd          , Dd          , Dd          , Dd^Edp      , Dd          , Dd          , Dd          , Dd          , Dd          , Hhd         , Hhd         , Hhd         , Hd          , Md          , Hhd         , Md          , Hhd         , Md          , Md          , Md          
Hd          , Hd          , Hhd         , Hd          , Md          , Md          , Md          , Md          , Md          , Md          , Md          , Md          , Md          , Md          , Md          , Hd          , Dd          , Dd^Edp      , Dd          , Dd          , Dd          , Dd          , Dd          , Hd          , Hd          , Md          , Md          , Md          , Md          , Md          , Md          , Md          , Md          , Md          , Hd          
Dd          , Hd          , Hhd         , Md          , Md          , Md          , Md          , Md          , Md          , Md          , Hd          , Hd          , Hhd         , Md          , Hhd         , Hd          , Dd          , Dd          , Dd          , Dd          , Dd          , Dd          , Dd          , Dd          , Hd          , Md          , Md          , Md          , Hd          , Md          , Hhd         , Hhd         , Hhd         , Hd          , Dd^Esd      
Dd          , Dd          , Dd          , Hhd         , Hd          , Hd          , Hd          , Hhd         , Hhd         , Hhd         , Dd^Edp      , Dd          , Dd^Esd      , Hhd         , Dd          , Dd          , Dd          , Dd          , Dd          , Dd          , Dd          , Dd          , Dd          , Dd          , Dd          , Hhd         , Hhd         , Hhd         , Dd          , Hd          , Dd          , Dd          , Dd          , Dd          , Dd          
Dd          , Dd          , Dd          , Dd^Esd      , Dd          , Dd          , Dd          , Dd          , Dd          , Dd^Es       , Dd          , Dd          , Dd          , Dd          , Dd          , Dd^Edp      , Dd          , Dd          , Dd^Edp      , Dd          , Dd          , Dd          , Dd          , Dd          , Dd          , Dd^Esd      , Dd          , Dd          , Dd          , Dd          , Dd          , Dd          , Dd^Es       , Dd          , Dd          
Dd          , Dd          , Dd          , Dd          , Dd^Edp      , Dd^Es       , Dd          , Dd          , Dd          , Dd          , Dd          , Dd          , Dd          , Dd          , Dd          , Dd          , Dd^Edp      , Dd          , Dd          , Dd          , Dd          , Dd          , Dd          , Dd          , Dd          , Dd^Edpp     , Dd          , Dd          , Dd          , Dd          , Dd          , Dd          , Dd^Es       , Dd          , Dd          
Dd          , Dd          , Dd          , Dd          , Dd          , Dd^Esd      , Dd          , Dd          , Dd          , Dd          , Dd          , Dd          , Dd^Esd      , Dd          , Dd^Edpp     , Dd          , Dd^Edp      , Dd          , Dd          , Dd          , Dd          , Dd          , Dd          , Dd          , Dd          , Dd          , Dd          , Dd          , Dd          , Dd          , Dd          , Dd^Edp      , Dd          , Dd          , Dd          
Dd          , Dd          , Dd          , Dd^Edpp     , Dd          , Dd          , Dd          , Dd          , Dd          , Dd          , Dd^Edpp     , Dd          , Dd          , Dd^Es       , Dd          , Dd          , Dd          , Dd          , Dd          , Dd          , Dd          , Dd          , Dd          , Dd          , Dd          , Dd          , Dd          , Dd          , Dd          , Dd          , Dd^Esd      , Dd          , Dd          , Dd          , Dd          
Dd          , Dd          , Dd          , Dd          , Dd          , Dd          , Dd          , Dd          , Dd          , Dd          , Dd          , Dd          , Dd          , Dd          , Dd          , Dd          , Dd          , Dd          , Gs          , Dd          , Dd          , Dd          , Gs^Ft       , Dd          , Dd          , Dd          , Dd          , Dd          , Dd          , Dd          , Dd          , Dd          , Dd          , Dd          , Dd          
Dd          , Dd^Edp      , Dd          , Dd          , Dd          , Dd          , Dd          , Dd          , Dd^Es       , Dd          , Dd          , Dd          , Dd          , Dd          , Dd          , Dd          , Cd          , Gs          , Gs^Ft       , Gs          , Cd          , Gs^Ft       , Gs^Ft       , Dd          , Dd          , Dd          , Gs          , Dd          , Dd          , Dd          , Dd          , Dd          , Dd          , Dd^Es       , Dd          
Dd          , Dd          , Dd          , Dd          , Dd          , Dd          , Dd          , Dd          , Dd          , Dd          , Dd          , Dd          , Cd          , Dd          , Gs          , Cd          , Cd          , Gs^Ft       , Gs^Ft       , Gs          , Cd          , Cd          , Dd          , Dd          , Dd          , Gs          , Cd          , Dd          , Gs^Ft       , Dd          , Dd          , Dd^Esd      , Dd          , Dd          , Dd          
Dd          , Dd          , Dd          , Dd          , Dd          , Dd          , Dd          , Dd          , Cd          , Dd          , Gs          , Cd          , Dd          , Dd          , Gs^Vc       , Gs          , Rr          , Gs          , Rr          , Rr          , Rr          , Dd          , Dd          , Cd          , Dd^Edpp     , Cd          , 7 Kd        , Cd          , Gs^Ft       , Gs^Ft       , Dd          , Dd          , Dd          , Dd          , Dd          
Dd          , Dd          , Dd          , Dd          , Gs^Ft       , Gs          , Gs          , Cd          , 3 Kd        , Cd          , Gs          , Gs          , Gs^Ft       , Gs^Ft       , Rr          , Rr          , Ww          , Rr          , Ww          , Dd          , Ww          , Rr          , Rr          , Dd          , Gs          , Cd          , Cd          , Cd          , Dd          , Gs^Vht      , Cd          , Dd          , Dd          , Dd          , Dd          
Dd          , Dd          , Dd          , Dd          , Gs^Ft       , Gs^Ft       , Gs          , Cd          , Cd          , Cd          , Rr          , Rr          , Rr          , Rr          , Ww          , Ww          , Wo          , Ww          , Wo          , Ww          , Wo          , Ww          , Ww          , Rr          , Rr          , Gs^Vc       , Gs          , Gs          , Gs          , Dd          , Dd          , Cd          , Dd          , Dd          , Dd          
Dd          , Dd          , Dd          , Dd          , Cd          , Cd          , Gs          , Gs          , Gs          , Rr          , Gs          , Gs          , Ww          , Ww          , Wo          , Wo          , Ww          , Wo          , Ww          , Wo          , Ww          , Wo          , Wo          , Ww          , Ww          , Rr          , Rr          , Gs^Ft       , Gs^Ft       , Gs          , Dd          , Cd          , Dd          , Dd          , Dd          
Dd          , Dd          , Dd          , Dd          , Cd          , Dd          , Gs          , Gs^Vc       , Gs          , Rr          , Gs^Em       , Gs^Ft       , Ww          , Wo          , Ww          , Ww^Vm       , Ww          , Ww          , Rrc         , Ww          , Cd          , Ww          , Ww          , Wo          , Wo          , Ww          , Rr          , Gs^Ft       , Gs          , Gs          , Dd          , Dd          , Dd          , Dd          , Dd          
Dd          , Dd          , Dd          , Dd          , Dd          , Dd          , Gs          , Gs          , Rr          , Rr          , Gs^Ft       , Gs^Ft       , Ww          , Wo          , Ww          , Ww          , Cd          , Rrc         , Rrc         , Cd          , Gs          , Cd          , Rrc         , Ww          , Wo          , Ww          , Ww          , Rr          , Rr          , Gs          , Gs          , Cd          , Dd          , Dd          , Dd          
Dd          , Dd          , Dd          , Dd          , Cd          , Gs          , Gs^Ft       , Rr          , Gs          , Gs          , Ww          , Ww          , Wo          , Wo          , Ww          , Ww          , Cd          , Gs^Vda      , Rrc         , Gs          , Gs^Vda      , Gs          , Rrc         , Ww          , Ww          , Wo          , Ww          , Gs^Em       , Rr          , Gs          , Gs^Ft       , Cd          , Dd          , Dd          , Dd          
Dd          , Dd          , Dd          , Dd          , Cd          , Gs          , Gs^Ft       , Rr          , Gs^Vc       , Ww          , Wo          , Wo          , Ww          , Ww          , Rrc         , Rrc         , Rrc         , Rrc         , Cd          , Rrc         , Rrc         , Rrc         , Gs          , Cd          , Ww          , Wo          , Ww          , Gs          , Rr          , Gs          , Gs^Ft       , Gs^Ft       , Dd          , Dd          , Dd          
Dd          , Dd          , Dd^Edp      , Dd          , Gs          , Gs^Ft       , Gs          , Rr          , Gs^Ft       , Ww          , Wo          , Ww          , Cd          , Cd          , Gs          , Rrc         , Rrc         , Cd          , 5 Kd        , Cd          , Rrc         , Gs^Vda      , Gs          , Cd          , Ww          , Wo          , Ww          , Gs^Ft       , Rr          , Gs^Vc       , Gs          , Cd          , Dd          , Dd          , Dd          
Dd          , Dd          , Dd          , Dd          , Cd          , Gs          , Gs          , Rr          , Gs^Ft       , Ww          , Wo          , Ww          , Cd          , Gs          , Gs^Vda      , Gs          , Rrc         , Cd          , Cd          , Cd          , Rrc         , Rrc         , Rrc         , Rrc         , Ww          , Wo          , Ww          , Gs^Ft       , Rr          , Gs          , Gs          , Cd          , Dd          , Dd          , Dd          
Dd          , Dd          , Dd          , Dd          , Cd          , Gs          , Gs^Ft       , Rr          , Gs          , Ww          , Wo          , Ww          , Ww          , Rrc         , Rrc         , Rrc         , Gs          , Rrc         , Rrc         , Rrc         , Gs^Vda      , Cd          , Ww          , Ww          , Wo          , Wo          , Ww          , Rr          , Gs          , Gs          , Dd^Es       , Dd          , Dd          , Dd          , Dd          
Dd          , Dd          , Dd          , Dd          , Dd          , Dd          , Gs^Ft       , Rr          , Rr          , Ww          , Ww          , Wo          , Ww          , Rrc         , Cd          , Gs          , Gs^Vda      , Gs          , Rrc         , Gs          , Gs          , Cd          , Ww          , Wo          , Ww          , Ww          , Gs          , Rr          , Gs^Ft       , Gs^Ft       , Dd          , Cd          , Dd          , Dd          , Dd          
Dd          , Dd          , Dd          , Dd          , Cd          , Dd          , Gs          , Rr          , Rr          , Rr          , Ww          , Wo          , Ww          , Cd          , Gs          , Gs          , Cd          , Gs          , Rrc         , Cd          , Cd          , Gs          , Ww          , Wo          , Ww          , Gs          , Gs^Vc       , Rr          , Gs^Ft       , Dd          , Dd          , Cd          , Dd          , Dd          , Dd          
Dd          , Dd          , Dd          , Dd          , Cd          , Gs          , Gs^Em       , Gs          , Rr          , Gs          , Ww          , Wo          , Wo          , Ww          , Ww          , Cd          , Cd          , Rrc         , Ww          , Cd          , Ww          , Ww          , Wo          , Wo          , Ww          , Gs^Ft       , Gs          , Rr          , Gs          , Dd          , Cd          , Dd          , Dd          , Dd          , Dd^Edpp     
Dd          , Dd          , Dd          , Dd          , Dd          , Gs          , Gs^Ft       , Gs^Ft       , Rr          , Gs^Vc       , Rr          , Ww          , Ww          , Wo          , Wo          , Ww          , Ww          , Ww          , Wo          , Ww          , Wo          , Wo          , Ww          , Ww          , Gs^Ft       , Gs^Ft       , Rr          , Rr          , Rr          , Cd          , 6 Kd        , Cd          , Dd          , Dd          , Dd          
Dd          , Dd          , Dd          , Dd          , Cd          , Cd          , Cd          , Rr          , Gs          , Rr          , Gs^Ft       , Rr          , Rr          , Ww          , Ww          , Wo          , Wo          , Wo          , Ww          , Wo          , Ww          , Ww          , Gs          , Gs          , Rr          , Rr          , Gs^Ft       , Gs          , Gs^Ft       , Cd          , Cd          , Cd          , Dd          , Dd          , Dd          
Dd          , Dd          , Dd          , Dd          , Cd          , 4 Kd        , Cd          , Gs          , Gs          , Gs          , Gs          , Gs^Ft       , Gs          , Rr          , Gs^Em       , Ww          , Ww          , Ww          , Rr          , Ww          , Gs          , Gs          , Rr          , Rr          , Gs          , Gs^Em       , Gs^Ft       , Gs          , Gs^Ft       , Gs^Ft       , Dd          , Dd          , Dd          , Dd          , Dd          
Dd          , Dd^Edp      , Dd          , Dd          , Dd          , Cd          , Dd^Esd      , Dd          , Cd          , Gs          , Dd          , Gs          , Gs          , Rr          , Rr          , Gs^Ft       , Gs^Ft       , Rr          , Rr          , Gs          , Rr          , Rr          , Gs^Ft       , Gs          , Gs          , Gs^Ft       , Cd          , Cd          , Dd          , Dd          , Dd          , Dd          , Dd          , Dd          , Dd          
Dd          , Dd          , Dd          , Dd          , Dd          , Dd^Es       , Dd          , Dd^Es       , Dd          , Cd          , Dd          , Dd          , Gs          , Gs^Vc       , Gs^Ft       , Rr          , Rr          , Rr          , Rr          , Rr          , Gs          , Gs^Vc       , Gs^Ft       , Gs^Ft       , Cd          , Dd          , Dd          , Dd          , Dd          , Dd          , Dd          , Dd          , Dd          , Dd          , Dd          
Dd          , Dd          , Dd          , Dd          , Dd          , Dd          , Dd          , Dd          , Dd          , Dd          , Dd          , Cd          , Cd          , Gs^Ft       , Gs^Ft       , Gs          , Cd          , Rr          , Re          , Re          , Cd          , Gs          , Dd          , Cd          , Dd          , Dd          , Dd          , Dd          , Dd          , Dd          , Dd          , Dd          , Dd          , Dd^Esd      , Dd          
Dd          , Dd          , Dd          , Dd          , Dd          , Dd          , Dd          , Dd          , Dd          , Dd          , Dd          , Dd          , Dd          , Dd          , Dd          , Cd          , Cd          , Re          , Re          , Re          , Cd          , Cd          , Dd          , Dd          , Dd          , Dd          , Dd          , Dd          , Dd          , Dd          , Dd          , Dd          , Dd          , Dd          , Dd          
Dd          , Dd          , Dd          , Dd          , Dd          , Dd          , Dd          , Dd          , Dd          , Dd          , Dd          , Dd          , Dd          , Dd^Esd      , Dd          , Dd          , Dd          , Re          , Re          , Re          , Dd          , Dd          , Dd          , Dd          , Dd          , Dd^Edp      , Dd          , Dd^Edp      , Dd          , Dd          , Dd          , Dd^Esd      , Dd          , Dd^Esd      , Dd          
