border_size=1
usage=map

Ms          , Ms          , Mm          , Ms          , Mm          , Mm^Xm       , Mm          , Ms          , Mm          , Mm          , Mm          , Mm^Xm       , Mm^Xm       , Mm          , Mm          , Ms          , Mm          , Mm^Xm       , Mm          , Hh          , Gg          , Gg          , Gg          , Gg          , Gg          , Gg          , Gg          , Gg          , Gg          , Gg          , Gg          , Gg          , Ha          , Ms          , Mm          , Ms          , Mm          , Mm^Xm       , Mm^Xm       , Ms          , Mm          , Mm^Xm       , Mm          , Ms          , Ms          , Ms          
Mm          , Mm          , Mm^Xm       , Mm^Xm       , Mm          , Mm          , Mm^Xm       , Mm          , Mm          , Mm^Xm       , Mm^Xm       , Mm          , Mm          , Mm^Xm       , Mm          , Mm          , Mm          , Mm          , Hh          , Hh          , Gg          , Gg          , Ce          , Gg          , Gg          , Gd^Vo       , Gg          , Gg          , Ce          , Gg          , Gg          , Ha          , Ms          , Ms          , Mm^Xm       , Mm          , Ms          , Mm          , Mm          , Mm^Xm       , Mm          , Mm          , Ms          , Ms^Xm       , Ms          , Mm          
Mm          , Mm^Xm       , Hh          , Mm^Vo       , Mm^Xm       , Mm          , Mm          , Mm^Xm       , Mm^Xm       , Mm          , Mm^Vo       , Mm^Xm       , Mm          , Mm          , Mm^Xm       , Mm^Xm       , Mm          , Mm          , Hhd         , Gg          , Gg          , Ce          , Ce          , 1 Ke        , Ce          , Gg          , Ce          , 8 Ke        , Ce          , Ce          , Gg          , Hh          , Ms          , Mm          , Mm          , Mm          , Ms          , Ms^Xm       , Ha          , Mm^Vo       , Mm^Xm       , Ms          , Mm          , Ms          , Ms          , Ms          
Hh          , Ce          , 9 Ke        , Ce          , Ce          , Mm^Xm       , Mm^Xm       , Mm          , Mm          , Mm          , Mm          , Mm          , Mm          , Mm^Xm       , Mm          , Mm          , Hh          , Hhd         , Gg          , Ce          , Gg          , Gd^Vo       , Gg          , Ce          , Ce          , Gg          , Ce          , Ce          , Gd^Vo       , Gg          , Hh          , Hh          , Mm          , Mm^Xm       , Mm          , Mm^Vo       , Hh          , Ha          , Ce          , Hh          , Hh          , Mm^Xm       , Mm^Xm       , Mm          , Mm          , Ms          
Mm          , Ce          , Ce          , Hh          , Ms^Xm       , Hh          , Mm^Vo       , Mm          , Mm          , Ms          , Ms          , Mm          , Mm          , Mm          , Hh          , Hh          , Gg          , Gg          , Gg          , Gg          , Gg          , Ce          , Ce          , Gg          , Gg          , Gg          , Gg          , Gg          , Gg          , Ha          , Ms          , Ms          , Mm          , Mm          , Ms^Xm       , Ha          , Ce          , Ce          , Ce          , Hh          , Mm^Xm       , Mm          , Mm          , Mm^Vo       , Mm^Xm       , Ms          
Ms          , Hh          , Hh          , Ms          , Ms          , Ms          , Mm          , Mm          , Mm          , Mm          , Hh          , Hh          , Hhd         , Hhd         , Gg          , Gg          , Gg          , Gg          , Hh          , Gg          , Gg          , Gg          , Gg          , Gg          , Gg          , Gg          , Gg          , Ce          , Gg          , Hh          , Mm          , Mm          , Mm^Xm       , Ms          , Ms          , Ha          , Ce          , 7 Ke        , Hh          , Hh          , Mm          , Mm^Xm       , Mm          , Mm          , Mm          , Mm          
Ms          , Ms          , Mm          , Ms          , Mm^Xm       , Ms          , Mm          , Mm          , Hhd         , Hh          , Gg          , Gg          , Gg          , Gg          , Gd^Vo       , Gg          , Gg          , Hh          , Hh          , Gg          , Gg          , Gg          , Gg          , Gg          , Gg          , Gd^Vo       , Gg          , Gg          , Gg          , Hh          , Hh          , Mm          , Mm          , Mm          , Mm          , Mm^Xm       , Hh          , Ce          , Hh          , Mm^Vo       , Mm^Xm       , Mm          , Mm          , Ms          , Ms          , Ms          
Mm          , Mm^Vo       , Mm^Xm       , Mm^Xm       , Mm          , Mm          , Ha          , Hhd         , Gg          , Gg          , Hh          , Hh          , Gg          , Gg          , Gg          , Gg          , Gg          , Gg          , Gg          , Gg          , Gg          , Gg          , Gg          , Gg          , Gg          , Gg          , Gg          , Gg          , Hh          , Gg          , Gg          , Hhd         , Hhd         , Hhd         , Hhd         , Mm          , Mm          , Mm^Xm       , Mm          , Mm          , Mm          , Mm^Xm       , Mm^Xm       , Mm          , Mm          , Ms          
Ms          , Mm          , Mm          , Mm          , Ms          , Ms          , Ha          , Gg          , Gg          , Gg          , Gg          , Hh          , Gg          , Gg          , Gg          , Gg          , Co          , Gg          , Hh          , Gg          , Co          , Co          , Gg          , Gg          , Gg          , Co          , Co          , Gg          , Hh          , Hh          , Gg          , Gg          , Gg          , Gg          , Gg          , Hh          , Ms          , Mm          , Ms          , Ms          , Mm          , Mm          , Mm          , Mm^Vo       , Ms          , Ms          
Hh          , Hh          , Gg          , Hh          , Hh          , Hh          , Gg          , Gg          , Gg          , Gg          , Gg          , Gg          , Gg          , Hh          , Gg          , Co          , Co          , Hh          , Ww          , Hh          , Ww          , Co          , Hh          , Gg          , Hh          , Co          , Ww          , Gg          , Gg          , Gg          , Gg          , Gd^Vo       , Gg          , Gg          , Gg          , Hh          , Hh          , Ms          , Ms          , Mm          , Mm          , Mm          , Mm          , Mm^Xm       , Mm          , Ms          
Gg          , Gg          , Gg          , Gg          , Gg          , Gg          , Gg          , Gg          , Gg          , Gd^Vo       , Gg          , Gg          , Gg          , Hh          , Gg          , Hh          , Ww          , Ww          , Wo          , Ww          , Wwf         , Ww          , Ww          , Hh          , Ww          , Ww          , Ww          , Ww          , Ww          , Hh          , Hh          , Gg          , Co          , Co          , Gg          , Gg          , Gg          , Ha          , Ha          , Hh          , Hh          , Hh          , Hhd         , Mm          , Hh          , Hh          
Gg          , Gg          , Gg          , Gg          , Gd^Vo       , Gg          , Gg          , Hh          , Hh          , Gg          , Gg          , Gg          , Co          , Gg          , Hh          , Hh          , Ww          , Wo          , Ww          , Ww          , Ww          , Wwf         , Ww          , Ww          , Wo          , Wo          , Ww          , Wo          , Wo          , Ww          , Ww          , Hh          , Ww          , Co          , Hh          , Gg          , Gg          , Gg          , Gg          , Gg          , Gg          , Gg          , Hh          , Hhd         , Gg          , Hh          
Hh          , Gg          , Gg          , Gg          , Gg          , Gg          , Gg          , Hh          , Gg          , Gg          , Gg          , Gg          , Co          , Co          , Ww          , Ww          , Ww          , Ww          , Hh          , Ww          , Hh          , Ww          , Hh          , Ww          , Ww          , Ww          , Hh          , Ww          , Ww          , Wo          , Ww          , Ww          , Wo          , Ww          , Ww          , Hh          , Gg          , Gg          , Gg          , Gd^Vo       , Gg          , Gg          , Gg          , Hh          , Gg          , Gg          
Hh          , Hh          , Ww          , Ww          , Ww          , Gg          , Hh          , Gg          , Gg          , Gg          , Co          , Gg          , Hh          , Ww          , Wwf         , Wwf         , Ww          , Hh          , Co          , Co          , Gg          , Hh          , Co          , Co          , Hh          , Hh          , Mm^Vo       , Mm          , Ms          , Ww          , Hh          , Ww          , Ww          , Wo          , Ww          , Hh          , Co          , Co          , Gg          , Gg          , Hh          , Gg          , Gg          , Hh          , Gg          , Gg          
Ww          , Ww          , Wo          , Ww          , Wo          , Ww          , Ww          , Hh          , Hh          , Co          , Co          , Hh          , Ww          , Ww          , Wwf         , Ww          , Co          , Hh          , Rb          , Co          , Gg          , Gg          , Rb          , Co          , Mm          , Mm^Xm       , Mm          , Mm          , Mm          , Ms          , Ms          , Hh          , Hh          , Ww          , Wo          , Ww          , Hh          , Co          , Gg          , Gg          , Hh          , Hh          , Gg          , Gg          , Gg          , Gg          
Ww          , Wo          , Ww          , Ww          , Ww          , Wo          , Ww          , Ww          , Ww          , Ww          , Ww          , Hh          , Ww          , Ww          , Ww          , Ww          , Co          , Co          , Gg          , Rb          , Gg          , Gd^Vo       , Rb          , Gg          , Mm          , Mm          , Mm^Xm       , Mm^Xm       , Mm          , Ms^Vo       , Ms          , Ms^Xm       , Ms          , Ww          , Ww          , Ww          , Ww          , Hh          , Gg          , Gg          , Gg          , Gg          , Gg          , Gg          , Gg          , Gg          
Ww          , Ww          , Hh          , Hh          , Hh          , Ww          , Ww          , Wo          , Wo          , Wo          , Ww          , Ww          , Wo          , Ww          , Hh          , Hh          , Gg          , Gg          , Rb          , Rb          , Rb          , Rb          , Co          , Co          , Mm          , Mm^Xm       , Mm          , Mm          , Mm          , Ms          , Ms          , Ms          , Ms          , Hh          , Ww          , Wo          , Ww          , Hh          , Co          , Gg          , Gg          , Gg          , Gd^Vo       , Gg          , Gg          , Gg          
Gg          , Gg          , Gg          , Hh          , Gg          , Gg          , Hh          , Ww          , Ww          , Ww          , Ww          , Wo          , Wo          , Ww          , Hh          , Gg          , Gd^Vo       , Rb          , Co          , Co          , Co          , Rb          , Gg          , Co          , Mm          , Mm          , Mm          , Mm^Xm       , Mm^Xm       , Mm          , Mm          , Ms          , Ms          , Hh          , Ww          , Wo          , Ww          , Co          , Co          , Gg          , Gg          , Gg          , Gg          , Gg          , Gg          , Gg          
Gg          , Gd^Vo       , Gg          , Gg          , Gg          , Gg          , Gg          , Co          , Co          , Hh          , Hh          , Ww          , Ww          , Ww          , Co          , Gg          , Gg          , Rb          , Co          , 2 Ko        , Co          , Rb          , Gg          , Gg          , Hh          , Mm          , Mm          , Mm          , Mm          , Mm^Xm       , Mm          , Mm          , Mm          , Ms          , Hh          , Ww          , Ww          , Ww          , Ww          , Gg          , Gg          , Hh          , Hh          , Hh          , Gg          , Gg          
Gg          , Gg          , Ce          , Ce          , Ce          , Gg          , Gg          , Co          , Gg          , Gg          , Hh          , Ww          , Wwf         , Ww          , Co          , Co          , Rb          , Rb          , Rb          , Co          , Rb          , Rb          , Gd^Vo       , Gg          , Co          , Hh          , Mm          , Mm^Xm       , Mm          , Mm^Vo       , Mm          , Mm^Xm       , Mm^Xm       , Mm          , Mm          , Hh          , Ww          , Ww          , Ww          , Hh          , Hh          , Gg          , Gg          , Hh          , Gg          , Gg          
Gg          , Hh          , Ce          , 4 Ke        , Ce          , Hh          , Gg          , Gg          , Gg          , Gg          , Co          , Ww          , Wwf         , Ww          , Hh          , Rb          , Gg          , Gg          , Rb          , Rb          , Co          , Rb          , Rb          , Co          , Co          , Hh          , Mm^Xm       , Mm          , Ms          , Mm          , Mm          , Mm          , Mm          , Mm^Xm       , Mm^Vo       , Hh          , Ww          , Wo          , Wo          , Ww          , Hh          , Gg          , Gg          , Gg          , Gg          , Gg          
Gg          , Hh          , Hh          , Ce          , Hh          , Hh          , Gd^Vo       , Gg          , Hh          , Co          , Co          , Ww          , Ww          , Ww          , Ww          , Hh          , Gg          , Gd^Vo       , Rb          , Co          , 3 Ko        , Co          , Rb          , Gg          , Gd^Vo       , Mm          , Mm          , Mm          , Mm^Xm       , Mm^Xm       , Mm          , Mm          , Mm          , Mm          , Ms          , Ms          , Ww          , Wo          , Wo          , Ww          , Gg          , Gg          , Gd^Vo       , Gg          , Gg          , Gg          
Gg          , Gg          , Gd^Vo       , Gg          , Gg          , Gg          , Gg          , Gg          , Hh          , Hh          , Gg          , Ww          , Ww          , Wo          , Ww          , Hh          , Co          , Gg          , Rb          , Co          , Co          , Co          , Rb          , Gg          , Hh          , Mm          , Mm          , Mm^Xm       , Mm          , Mm          , Mm^Vo       , Mm          , Mm          , Mm          , Hh          , Hh          , Ww          , Wo          , Ww          , Ww          , Co          , Gg          , Gg          , Gg          , Gg          , Gg          
Hh          , Hh          , Hh          , Gg          , Ha          , Gg          , Gg          , Gg          , Gg          , Gg          , Gg          , Hh          , Ww          , Wo          , Wo          , Ww          , Co          , Co          , Rb          , Rb          , Rb          , Rb          , Gd^Vo       , Rb          , Hh          , Mm          , Mm^Vo       , Mm          , Mm          , Mm^Xm       , Mm^Xm       , Mm          , Mm          , Ms          , Hh          , Ww          , Wo          , Ww          , Ww          , Co          , Co          , Gg          , Hh          , Ha          , Hh          , Hh          
Ms          , Ms          , Mm          , Ha          , Ms          , Hh          , Hh          , Gg          , Gg          , Gd^Vo       , Gg          , Hh          , Hh          , Ww          , Ww          , Ww          , Ww          , Rb          , Hh          , Hh          , Hh          , Gg          , Co          , Rb          , Ha          , Hh          , Ms          , Mm          , Ms          , Mm          , Mm          , Mm^Xm       , Mm          , Mm          , Ww          , Ww          , Wo          , Wo          , Ww          , Hhd         , Hh          , Hh          , Mm          , Ms          , Ms          , Ms          
Ms          , Ms          , Mm^Xm       , Mm          , Mm          , Ms          , Mm^Xm       , Ms          , Ms          , Gg          , Gg          , Co          , Co          , Ww          , Ww          , Wwf         , Wwf         , Ww          , Ww          , Ww          , Ww          , Co          , Co          , Rb          , Hh          , Ha          , Hh          , Hh          , Ms          , Ms          , Hh          , Mm          , Ms          , Ms          , Ww          , Wo          , Ww          , Ww          , Hhd         , Hhd         , Mm^Xm       , Mm^Xm       , Mm          , Mm          , Mm          , Ms          
Ms          , Mm          , Mm^Vo       , Mm^Xm       , Mm^Xm       , Mm          , Mm          , Mm^Xm       , Mm^Xm       , Hh          , Hh          , Co          , Ha          , Gg          , Gg          , Ww          , Ww          , Ww          , Wo          , Wo          , Wo          , Ww          , Ww          , Ww          , Ww          , Hh          , Ww          , Ww          , Ww          , Hh          , Ww          , Hh          , Ww          , Ww          , Ww          , Ww          , Ha          , Hh          , Mm          , Mm^Xm       , Mm          , Mm^Vo       , Mm          , Mm^Xm       , Mm^Vo       , Ms          
Ms          , Ms          , Ms          , Mm          , Mm          , Mm          , Mm^Xm       , Mm          , Mm^Vo       , Mm          , Ms          , Ha          , Ms          , Ha          , Gg          , Hh          , Hh          , Ww          , Ww          , Wo          , Ww          , Ww          , Ww          , Wwf         , Wwf         , Ww          , Wo          , Wo          , Ww          , Ww          , Wo          , Ww          , Wo          , Ww          , Ww          , Co          , Co          , Hh          , Mm          , Mm          , Mm^Xm       , Mm^Xm       , Mm          , Mm          , Mm^Xm       , Ms          
Mm          , Mm^Xm       , Mm^Xm       , Mm          , Mm          , Mm          , Mm          , Mm^Xm       , Mm^Xm       , Mm          , Mm          , Mm^Xm       , Mm^Xm       , Ms          , Hh          , Gg          , Gg          , Hh          , Co          , Ww          , Hh          , Ww          , Hh          , Ww          , Ww          , Ww          , Ww          , Ww          , Ww          , Ww          , Ww          , Wo          , Ww          , Ww          , Ms          , Co          , Mm          , Mm          , Mm          , Mm^Xm       , Mm^Vo       , Mm          , Ms          , Mm          , Mm          , Mm          
Mm          , Mm          , Mm          , Mm^Xm       , Mm          , Mm          , Mm          , Mm          , Mm          , Mm          , Mm          , Mm          , Mm          , Mm^Xm       , Mm          , Hh          , Ha          , Co          , Co          , Gg          , Gg          , Hh          , Gg          , Co          , Co          , Hh          , Hh          , Hh          , Co          , Co          , Gg          , Ww          , Ha          , Ha          , Ms          , Mm          , Ms          , Ms          , Mm^Xm       , Mm          , Mm          , Mm          , Mm          , Ms          , Ms          , Ms          
Ms          , Mm          , Mm          , Mm          , Ms          , Ms          , Mm          , Mm^Xm       , Mm^Xm       , Mm          , Mm          , Mm^Vo       , Mm          , Mm          , Ms          , Ms          , Mm          , Ha          , Hh          , Hh          , Hh          , Gg          , Gg          , Co          , Gg          , Gg          , Gg          , Gg          , Gg          , Co          , Gg          , Ha          , Ms          , Ms          , Mm          , Mm^Xm       , Mm^Xm       , Mm          , Mm          , Mm^Xm       , Mm^Xm       , Mm          , Mm^Vo       , Mm          , Ms          , Mm          
Ms          , Ms          , Mm          , Mm^Vo       , Mm          , Mm^Xm       , Mm^Xm       , Mm          , Mm          , Mm^Xm       , Mm          , Mm          , Mm          , Mm^Xm       , Mm^Xm       , Mm          , Mm          , Mm          , Mm          , Ms          , Ms          , Ha          , Gg          , Gg          , Hh          , Gg          , Hh          , Hh          , Gg          , Gg          , Hh          , Ha          , Mm          , Mm          , Mm          , Mm^Vo       , Mm          , Mm^Xm       , Mm          , Mm          , Mm          , Mm          , Mm          , Mm          , Mm          , Mm          
Mm          , Mm          , Mm^Xm       , Mm^Xm       , Mm          , Mm          , Mm^Vo       , Mm^Xm       , Mm          , Mm          , Mm^Xm       , Mm          , Mm          , Mm          , Mm          , Mm^Xm       , Mm^Vo       , Mm          , Mm^Xm       , Ms          , Mm          , Ha          , Hh          , Gg          , Gg          , Gg          , Gg          , Hh          , Gg          , Gg          , Hh          , Ms          , Mm^Xm       , Mm^Xm       , Mm          , Mm          , Mm^Xm       , Mm          , Mm          , Mm^Vo       , Mm          , Mm^Xm       , Mm^Xm       , Mm          , Mm          , Ms          
Mm          , Mm^Xm       , Mm          , Mm          , Mm          , Ms          , Mm          , Mm          , Mm^Xm       , Mm^Xm       , Mm          , Mm          , Ms          , Mm          , Ms          , Mm          , Mm^Xm       , Mm^Xm       , Mm          , Mm          , Mm^Vo       , Mm          , Mm          , Hh          , Gg          , Hh          , Hh          , Gg          , Ha          , Hh          , Mm          , Mm^Xm       , Mm^Vo       , Mm          , Mm^Xm       , Mm^Xm       , Mm          , Mm          , Mm          , Mm^Xm       , Mm          , Mm          , Mm          , Mm^Xm       , Mm^Vo       , Ms          
Ms          , Mm          , Mm          , Mm          , Mm          , Mm          , Ms          , Mm          , Mm          , Mm          , Ms          , Ms          , Ms          , Ms          , Mm          , Mm          , Mm          , Mm          , Mm          , Mm          , Mm          , Mm          , Ms          , Hh          , Gg          , Hh          , Gg          , Gg          , Hh          , Ms          , Ms          , Mm          , Ms          , Mm          , Mm          , Mm          , Ms          , Ms          , Ms          , Mm          , Ms          , Ms          , Ms          , Mm          , Ms          , Ms          
