border_size=1
usage=map

Hh          , Hh          , Gs^Fms      , Gs^Fms      , Gs^Fms      , Gg          , Gs^Fms      , Gs^Fms      , Hh          , Hh          , Hh          , Gg          , Gg          , Gg          , Gs^Fms      , Gs^Fms      , Gg          , Gg          , Gs^Fms      , Hh          , Hh          , Hh          
Hh          , Hh          , Gg          , Gg          , Gg          , Gg          , Gg          , Gs^Fms      , Gg          , Hh          , Gs^Fms      , Gg          , Gg          , Gg          , Gg          , Gs^Fms      , Gg          , Gs^Fms      , Gs^Fms      , Gg          , Gg          , Hh          
Gg          , Gg          , Gs^Fms      , Gs^Fms      , Hh          , Gg          , Gs^Fms      , Gg          , Gg          , Gg          , Gs^Fms      , Gs^Fms      , Hh          , Hh          , Gs^Fms      , Gg          , Hh          , Gs^Fms      , Hh          , Gg          , Gg          , Gg          
Gs^Fms      , Gs^Fms      , Gs^Fms      , Hh          , Hh          , Hh          , Gs^Fms      , Gg          , Hh          , Hh          , Gg          , Gs^Fms      , Hh          , Hh          , Gs^Fms      , Gs^Fms      , Gg          , Hh          , Hh          , Gs^Fms      , Gs^Fms      , Gg          
Gs^Fms      , Gs^Fms      , Gg          , Gs^Fms      , Gg          , Gs^Fms      , Gs^Fms      , Gg          , 1 Hh        , Hh          , Gg          , Gg          , Gg          , Gg          , Gg          , Gs^Fms      , Gg          , Gg          , Gs^Fms      , Gs^Fms      , Gg          , Gg          
Hh          , Hh          , Gg          , Gg          , Gs^Fms      , 8 Gs^Fms    , Gs^Fms      , Gg          , Gg          , Gs^Fms      , Gs^Fms      , Hh          , Hh          , Gg          , Gg          , Gg          , Hh          , Gg          , Gg          , Gs^Fms      , Gg          , Gg          
Hh          , Hh          , Gg          , Gg          , Hh          , Gs^Fms      , Gs^Fms      , Gs^Fms      , Hh          , Gs^Fms      , Gg          , Hh          , Gs^Fms      , Hh          , Gg          , Gg          , Hh          , Hh          , Gg          , Gg          , Hh          , Gg          
Gs^Fms      , Gs^Fms      , Gg          , Gs^Fms      , Hh          , Hh          , Gs^Fms      , Hh          , 7 Hh        , Gg          , Gg          , Gs^Fms      , Gs^Fms      , Gs^Fms      , Gs^Fms      , Gg          , Gg          , Gg          , Gs^Fms      , Gs^Fms      , Hh          , Hh          
Gs^Fms      , Gs^Fms      , Gg          , Gs^Fms      , Gs^Fms      , 9 Hh        , Gg          , Gs^Fms      , Gg          , Gg          , Hh          , Hh          , Gs^Fms      , Gs^Fms      , Gg          , Gs^Fms      , Hh          , Gg          , Gs^Fms      , Gs^Fms      , Gs^Fms      , Gg          
Hh          , Gs^Fms      , Gs^Fms      , Gg          , Gg          , Gg          , Gg          , Gg          , Hh          , Gg          , Gg          , Gs^Fms      , Gg          , Gg          , Gg          , Hh          , Hh          , Gg          , Gg          , Gs^Fms      , Gg          , Gg          
Hh          , Hh          , Hh          , Gs^Fms      , Gs^Fms      , Gg          , Gg          , Hh          , Hh          , Gs^Fms      , Gs^Fms      , Gg          , Hh          , Hh          , Gg          , Gs^Fms      , Gs^Fms      , Hh          , Gg          , Gg          , Hh          , Hh          
Hh          , Hh          , Hh          , Gs^Fms      , Gs^Fms      , Gs^Fms      , Hh          , Hh          , Hh          , Gs^Fms      , Gs^Fms      , Gg          , Hh          , Hh          , Gg          , Gs^Fms      , Gs^Fms      , Gg          , Gg          , Hh          , Hh          , Hh          
