border_size=1
usage=map

Gg          , Gg          , Gg          , Gg          , Gg          , Gg          , Gg          , Gg          , Gg          , Gg          , Gg          , Gg          , Gg          , Gg          , Gg          , Gg          , Gg          , Gg          , Gg          , Ww          , Wo          , Ww          , Gg          , Gg          , Gg          , Gg          , Gg          , Gg          , Gg          , Gg          , Gg          , Gg          , Gg          , Gg          , Gg          , Gg          , Gg          , Gg          , Gg          , Gg          , Gg          , Gg          , Gg          , Gg          , Gg          , Gg          
Gg          , Gg          , Gg          , Gg          , Gg          , Gg          , Gg          , Gg          , Gg          , Gg          , Gg          , Gg          , Gg          , Gg          , Gg          , Gg          , Gg          , Gg          , Gg          , Ww          , Wo          , Ww          , Gg          , Gg          , Gg          , Gg          , Gg          , Gg          , Gg          , Gg          , Gg          , Gg          , Gg          , Gg          , Gg          , Gg          , Gg          , Gg          , Rb          , Gg          , Gg          , Gg          , Gg          , Gg          , Gg          , Gg          
Gg          , Gg          , Gg          , Gg          , Gg          , Gg          , Gg          , Gg          , Rb^Cov      , Rb^Cov      , Rb^Cov      , Gg          , Gg          , Gg          , Gs          , Gg          , Gs          , Gg          , Gg          , Ww          , Wo          , Ww          , Gg          , Gg          , Gg          , Gg          , Gg          , Gg          , Gg          , Gg          , Gg          , Gg          , Gg          , Gg          , Gg          , Gg          , Re^Vct      , Re          , Ce          , Rb          , Re^Vct      , Gg          , Gg          , Gg          , Gg          , Gg          
Gg          , Gg          , Gg          , Gs          , Gs          , Gs          , Gs          , Gs          , Rb^Cov      , 3 Ke        , Rb^Cov      , Re^Vct      , Gs          , Gs          , Gs          , Gs          , Gs          , Gs          , Gs          , Ww          , Ww          , Ww          , Gs          , Gs          , Gs          , Gs          , Gs          , Gg          , Gs          , Gg          , Gg          , Gg          , Gg          , Gg          , Gg          , Gg          , Re          , Ce          , 2 Ke        , Ce          , Re          , Gg          , Gg          , Gg          , Gg          , Gg          
Gg          , Gg          , Gs          , Gs          , Gs          , Gs          , Gs          , Gs          , Gs          , Rb^Cov      , Gs          , Gs          , Gd^Fmw      , Gs          , Gd^Fmw      , Gd^Fmw      , Gs^Fdw      , Gd^Fmw      , Gd^Fmw      , Ww          , Wwf         , Gd^Fmw      , Gd^Fmw      , Gd^Fmw      , Gs          , Gs          , Gs          , Gs          , Gs          , Gs          , Gs          , Gg          , Gs          , Gg          , Gs          , Gg          , Re^Vct      , Ce          , Ce          , Ce          , Re          , Gg          , Gg          , Gg          , Gg          , Gg          
Gs          , Gs          , Gs^Fdw      , Gs          , Gd^Fmw      , Gs          , Gd^Fmw      , Gd^Fmw      , Gs^Fdw      , Gs          , Gd^Fmw      , Gd^Fmw      , Gs^Fdw      , Gs^Fdw      , Gs^Fdw      , Gll^Fp      , Gll^Fp      , Gs^Fdw      , Ww          , Ww          , Wwf         , Gs^Fdw      , Gs^Fdw      , Gs^Fdw      , Gll^Fp      , Gd^Fmw      , Gd^Fmw      , Gd^Fmw      , Gs          , Gs          , Gs          , Gs          , Gs          , Gs          , Gs          , Gs          , Gs          , Re          , Rb          , Re          , Gg          , Re^Vct      , Gg          , Gg          , Gg          , Gg          
Gd^Fmw      , Gd^Fmw      , Gs^Fdw      , Gd^Fmw      , Gs^Fdw      , Gs^Fdw      , Gs^Fdw      , Gs^Fdw      , Gll         , Gd^Fmw      , Gll^Fp      , Gll^Fp      , Gll^Fp      , Gs^Fdw      , Gll^Fp      , Gll^Fp      , Wwf         , Wwf         , Ww          , Wwf         , Gs^Fdw      , Gll         , Gll         , Gll^Fp      , Gll         , Gll^Fp      , Gs^Fdw      , Gd^Fmw      , Gs^Fdw      , Gd^Fmw      , Gd^Fmw      , Gs          , Gs          , Gs          , Gs          , Gs          , Gs          , Gs          , Gd^Fmw      , Gs          , Gs          , Gg          , Gs          , Gg          , Gs          , Gg          
Gd^Fmw      , Gs^Fdw      , Gll         , Gd^Fmw      , Gll^Fp      , Gll^Fp      , Gll^Fp      , Gll^Fp      , Gs^Fdw      , Gll         , Gll         , Gd^Fmw      , Gd^Fmw      , Gll^Fp      , Gs^Fdw      , Gs^Fdw      , Wwf         , Ww          , Gd^Fmw      , Gd^Fmw      , Gs^Fdw      , Gll^Fp      , Gll         , Gll         , Gd^Fmw      , Gll         , Gll         , Gs^Fdw      , Gll^Fp      , Gll^Fp      , Gd^Fmw      , Gd^Fmw      , Gs^Fdw      , Gs^Fdw      , Gd^Fmw      , Gs          , Gd^Fmw      , Gd^Fmw      , Gs^Fdw      , Gs^Fdw      , Gs^Fdw      , Gs          , Gs          , Gs          , Gs          , Gs          
Gll^Fp      , Gll^Fp      , Gll         , Gll         , Gll         , Gll         , Gll         , Gll         , Gll         , Gs^Fdw      , Gll^Fp      , Gll         , Gd^Fmw      , Gs^Fdw      , Gd^Fmw      , Gd^Fmw      , Ww          , Ww          , Gd^Fmw      , Gs^Fdw      , Gll^Fp      , Gll^Fp      , Gll         , Gll         , Gll         , Gd^Fmw      , Gll^Fp      , Gll         , Gll         , Gll^Fp      , Gll         , Gll         , Gd^Fmw      , Gs^Fdw      , Gll^Fp      , Gd^Fmw      , Gd^Fmw      , Gd^Fmw      , Gll^Fp      , Gs^Fdw      , Gll^Fp      , Gd^Fmw      , Gd^Fmw      , Gs          , Gd^Fmw      , Gs          
Gll         , Gll         , Gll         , Gll^Fp      , Gs^Fdw      , Gll         , Gd^Fmw      , Gll^Fp      , Gll         , Gll         , Gd^Fmw      , Gll         , Gll^Fp      , Gs^Fdw      , Gll^Fp      , Gd^Fmw      , Ww          , Ww          , Gll^Fp      , Gll         , Gll         , Gll         , Gd^Fmw      , Gll^Fp      , Gll         , Gll^Fp      , Gll         , Gd^Fmw      , Gd^Fmw      , Gll         , Gll^Fp      , Gd^Fmw      , Gll         , Gd^Fmw      , Gll         , Gll         , Gll         , Gd^Fmw      , Gll         , Gll^Fp      , Gll         , Gll         , Gll         , Gd^Fmw      , Gs^Fdw      , Gd^Fmw      
Gll^Fp      , Gll^Fp      , Gll^Fp      , Gs^Fdw      , Gll         , Gll^Fp      , Gd^Fmw      , Gll         , Gll         , Gd^Fmw      , Gll         , Gll         , Gll         , Gll         , Gd^Fmw      , Gs^Fdw      , Wwf         , Ww          , Gll^Fp      , Gll         , Gd^Fmw      , Gll         , Gll         , Gd^Fmw      , Gll^Fp      , Gll         , Gll^Fp      , Gll         , Gll         , Gd^Fmw      , Gll         , Gll^Fp      , Gll^Fp      , Gll         , Gll^Fp      , Gll         , Gd^Fmw      , Gll         , Gll         , Gll         , Gll^Fp      , Gll^Fp      , Gll         , Gs^Fdw      , Gs^Fdw      , Gd^Fmw      
Gd^Fmw      , Gll         , Gll         , Gs^Fdw      , Gll         , Gll         , Gll         , Gll         , Gll         , Gll^Fp      , Gll         , Gll^Fp      , Gll         , Gd^Fmw      , Gs^Fdw      , Gs^Fdw      , Wwf         , Ww          , Gs^Fdw      , Gs^Fdw      , Gll         , Gll^Fp      , Gll         , Gd^Fmw      , Gll         , Gll^Fp      , Gll         , Gll         , Gll         , Gll^Fp      , Gd^Fmw      , Gll         , Gll         , Gll         , Gll         , Gll         , Gd^Fmw      , Gll^Fp      , Gll         , Gd^Fmw      , Gll^Fp      , Gll         , Gll^Fp      , Gll^Fp      , Gd^Fmw      , Gd^Fmw      
Gll         , Gd^Fmw      , Gll         , Gll         , Gll         , Gll^Fp      , Gll         , Gll^Fp      , Gll^Fp      , Gll         , Gll         , Gd^Fmw      , Gll         , Gll^Fp      , Gd^Fmw      , Gd^Fmw      , Ww          , Ww          , Gd^Fmw      , Gs^Fdw      , Gll^Fp      , Gll         , Gll         , Gll^Fp      , Gs^Fdw      , Gll         , Gll         , Gll^Fp      , Gs^Fdw      , Gll         , Gll^Fp      , Gd^Fmw      , Gll         , Gd^Fmw      , Gd^Fmw      , Gll         , Gll         , Gll^Fp      , Gll         , Gd^Fmw      , Gd^Fmw      , Gll         , Gs^Fdw      , Gll^Fp      , Gd^Fmw      , Gs          
Gll         , Gll         , Gll^Fp      , Gll^Fp      , Gll         , Gs^Fdw      , Gll         , Gll         , Gll^Fp      , Gll         , Gll^Fp      , Gd^Fmw      , Gll^Fp      , Gs^Fdw      , Gd^Fmw      , Ww          , Wwf         , Wwf         , Gd^Fmw      , Gs^Fdw      , Gll^Fp      , Gll         , Gd^Fmw      , Gll         , Gll         , Gs^Fdw      , Gll         , Gs^Fdw      , Gs^Fdw      , Gll         , Gll         , Gd^Fmw      , Gll^Fp      , Gll         , Gll^Fp      , Gll^Fp      , Gll         , Gll         , Gll^Fp      , Gll         , Gll^Fp      , Gll         , Gd^Fmw      , Gs^Fdw      , Gs          , Gs          
Gll         , Gd^Fmw      , Gd^Fmw      , Gll         , Gs^Fdw      , Gs^Fdw      , Gll         , Gll^Fp      , Gll         , Gll         , Gll         , Gd^Fmw      , Gll         , Gs^Fdw      , Gs^Fdw      , Ww          , Wwf         , Gd^Fmw      , Gll         , Gll^Fp      , Gs^Fdw      , Gll         , Gll^Fp      , Gll^Fp      , Gll         , Gs^Fdw      , Gll         , Gll^Fp      , Gll^Fp      , Gll^Fp      , Gll^Fp      , Gll         , Gll         , Gll         , Gll         , Gll         , Gd^Fmw      , Gll         , Gll         , Gll^Fp      , Gll         , Gll         , Gd^Fmw      , Gs^Fdw      , Gs          , Gs          
Gll         , Gll         , Gll^Fp      , Gll         , Gll         , Gll         , Gll         , Gll^Fp      , Gll         , Gll^Fp      , Gll^Fp      , Gll         , Gll^Fp      , Gll^Fp      , Gd^Fmw      , Ww          , Wwf         , Gll         , Gll^Fp      , Gll         , Gs^Fdw      , Gll         , Gll         , Gd^Fmw      , Gd^Fmw      , Gll         , Gll^Fp      , Gll         , Gll         , Gd^Vc       , Gll^Fp      , Gd^Fetd     , Gll         , Gd^Fmw      , Gll         , Gd^Fmw      , Gll         , Gd^Fmw      , Gll^Fp      , Gll         , Gll         , Gd^Fmw      , Gs^Fdw      , Gs          , Gs          , Gs          
Gll         , Gll         , Gll         , Gll         , Gll^Fp      , Gll         , Gll         , Gll         , Gll         , Gll         , Gll^Fp      , Gll         , Gd^Fmw      , Gs^Fdw      , Gd^Fmw      , Ww          , Ww          , Gs^Fdw      , Gll^Fp      , Gll         , Gll         , Gs^Fdw      , Gll         , Gll         , Gd^Fmw      , Gll         , Gs^Fdw      , Gll^Fp      , Gs^Fdw      , Gs^Fdw      , Gs^Fdw      , Gll         , Gd^Fmw      , Gll         , Gll         , Gll         , Gd^Fmw      , Gll         , Gll         , Gll^Fp      , Gll         , Gs^Fdw      , Gd^Fmw      , Gs          , Gs          , Gs          
Gll         , Gll^Fp      , Gll^Fp      , Gll         , Gs^Fdw      , Gs^Fdw      , Gll         , Gll^Fp      , Gll^Fp      , Gd^Fmw      , Gll         , Gll         , Gd^Fmw      , Gs^Fdw      , Gs^Fdw      , Ww          , Ww          , Gs^Fdw      , Gs^Fdw      , Gll^Fp      , Gll         , Gll         , Gs^Fdw      , Gll         , Gll         , Gll^Fp      , Gs^Fdw      , Gll^Fp      , Gll^Fp      , Gll         , Gll^Fp      , Gll         , Gd^Fmw      , Gll         , Gll^Fp      , Gd^Fmw      , Gll         , Gd^Fmw      , Gll^Fp      , Gll         , Gll^Fp      , Gs^Fdw      , Gs          , Gs          , Gs          , Gs          
Gll         , Gll         , Gll         , Gs^Fdw      , Gll         , Gll^Fp      , Gll         , Gll^Fp      , Gd^Fmw      , Gd^Fmw      , Gll         , Gll^Fp      , Gs^Fdw      , Gd^Fmw      , Gd^Fmw      , Wwf         , Ww          , Gd^Fmw      , Gs^Fdw      , Gll         , Gll         , Gs^Fdw      , Gll         , Gll         , Gd^Fmw      , Gs^Fdw      , Gll         , Gll         , Gd^Fmw      , Gll         , Gll         , Gll         , Gll^Fp      , Gll         , Gll         , Gll         , Gd^Fmw      , Gll         , Gll         , Gll         , Gll^Fp      , Gll^Fp      , Gs          , Gs          , Gs          , Gs          
Gll         , Gll^Fp      , Gll^Fp      , Gll         , Gs^Fdw      , Gll         , Gs^Fdw      , Gll         , Gll^Fp      , Gll         , Gd^Fmw      , Gs^Fdw      , Gd^Fmw      , Gd^Fmw      , Wwf         , Wwf         , Ww          , Gd^Fmw      , Gd^Fmw      , Gll^Fp      , Gll         , Gs^Fdw      , Gll^Fp      , Gd^Fmw      , Gll         , Gll         , Gll^Fp      , Gd^Fmw      , Gd^Fmw      , Gll^Fp      , Gll         , Gll         , Gd^Fmw      , Gll         , Gll         , Gd^Fmw      , Gll^Fp      , Gs^Fdw      , Gs^Fdw      , Gll         , Gll^Fp      , Gs^Fdw      , Gd^Fmw      , Gs          , Gs          , Gs          
Gll         , Gll         , Gd^Fmw      , Gll^Fp      , Gg          , Gs^Fdw      , Gll^Fp      , Gll         , Gs^Fdw      , Gll^Fp      , Gd^Fmw      , Gs^Fdw      , Ww          , Ww          , Ww          , Ww          , Ww          , Ww          , Ww          , Gll^Fp      , Gll^Fp      , Gll         , Gll         , Gll         , Gll^Fp      , Gll         , Gll         , Gs^Fdw      , Gll         , Gll         , Gll         , Gd^Fmw      , Gll         , Gll         , Gll^Fp      , Gs^Fdw      , Gd^Fmw      , Gs^Fdw      , Gd^Fmw      , Gs^Fdw      , Gd^Fmw      , Gs^Fdw      , Gs^Fdw      , Gd^Fmw      , Gs          , Gs          
Gd^Fmw      , Gll^Fp      , Gs^Fdw      , Gd^Fmw      , Gll^Fp      , Gg          , Gs^Fdw      , Gs^Fdw      , Gd^Fmw      , Gs^Fdw      , Wwf         , Ww          , Ww          , Ww          , Gs^Fdw      , Gd^Fmw      , Gd^Fmw      , Ww          , Ww          , Gd^Fmw      , Gd^Fmw      , Gll         , Gll^Fp      , Gll         , Gd^Fmw      , Gd^Fmw      , Gll^Fp      , Gll         , Gll^Fp      , Gd^Fmw      , Gd^Fmw      , Gll         , Gd^Fmw      , Gll^Fp      , Gd^Fmw      , Gd^Fmw      , Wwf         , Ww          , Ww          , Gd^Fmw      , Wwf         , Gd^Fmw      , Gll^Fp      , Gd^Fmw      , Gd^Fmw      , Gs          
Ww          , Gd^Fmw      , Gs^Fdw      , Gs^Fdw      , Gd^Fmw      , Gd^Fmw      , Ww          , Gd^Fmw      , Wwf         , Gd^Fmw      , Wwf         , Ww          , Gd^Fmw      , Gs^Fdw      , Gll         , Gs^Fdw      , Gd^Fmw      , Ww          , Ww          , Wwf         , Gd^Fmw      , Gs^Fdw      , Gll^Fp      , Gll         , Gll         , Gll^Fp      , Gll         , Gll         , Gll         , Gll         , Gll         , Gll         , Gll^Fp      , Gs^Fdw      , Gs^Fdw      , Wwf         , Ww          , Ww          , Ww          , Wwf         , Ww          , Wwf         , Gll^Fp      , Gs^Fdw      , Gd^Fmw      , Gs          
Ww          , Ww          , Wwf         , Gd^Fmw      , Wwf         , Ww          , Ww          , Ww          , Ww          , Wwf         , Ww          , Ww          , Gd^Fmw      , Gll^Fp      , Gll         , Gll^Fp      , Gs^Fdw      , Gs^Fdw      , Ww          , Wwf         , Wwf         , Gs^Fdw      , Gs^Fdw      , Gll^Fp      , Gs^Fdw      , Gd^Fmw      , Gll^Fp      , Gll^Fp      , Gs^Fdw      , Gs^Fdw      , Gs^Fdw      , Gll^Fp      , Gll^Fp      , Gs^Fdw      , Gd^Fmw      , Wwf         , Ww          , Wo          , Wo          , Ww          , Wo          , Ww          , Wwf         , Gs^Fdw      , Gs^Fdw      , Gd^Fmw      
Gd^Fmw      , Ww          , Ww          , Wwf         , Ww          , Ww          , Gd^Fmw      , Ww          , Gd^Fmw      , Ww          , Gs^Fdw      , Gd^Fmw      , Gll^Fp      , Gll^Fp      , Gll         , Gd^Fmw      , Gll^Fp      , Gs^Fdw      , Gd^Fmw      , Ww          , Ww          , Wwf         , Gd^Fmw      , Gs^Fdw      , Gd^Fmw      , Gs^Fdw      , Ww          , Ww          , Ww          , Gd^Fmw      , Gd^Fmw      , Gd^Fmw      , Wwf         , Gd^Fmw      , Gd^Fmw      , Ww          , Wo          , Wo          , Wo          , Wo          , Wo          , Ww          , Ww          , Wwf         , Gd^Fmw      , Gd^Fmw      
Gd^Fmw      , Gd^Fmw      , Gs^Fdw      , Ww          , Gd^Fmw      , Gs^Fdw      , Gs^Fdw      , Gd^Fmw      , Gll^Fp      , Gs^Fdw      , Gll^Fp      , Gs^Fdw      , Gll         , Gll         , Gd^Fmw      , Gll         , Gll         , Gll         , Gs^Fdw      , Gd^Fmw      , Ww          , Ww          , Ww          , Gd^Fmw      , Ww          , Ww          , Wwf         , Wwf         , Wwf         , Ww          , Ww          , Wwf         , Ww          , Wwf         , Wwf         , Ww          , Wo          , Wo          , Wo          , Wo          , Wo          , Wo          , Ww          , Wwf         , Gd^Fmw      , Gd^Fmw      
Gd^Fmw      , Gll^Fp      , Gs^Fdw      , Gd^Fmw      , Gll^Fp      , Gll^Fp      , Gs^Fdw      , Gll         , Gll         , Gll^Fp      , Gll         , Gll         , Gs^Fdw      , Gs^Fdw      , Gs^Fdw      , Gll         , Gd^Fmw      , Gll^Fp      , Gs^Fdw      , Gd^Fmw      , Gs^Fdw      , Ww          , Ww          , Ww          , Wwf         , Wwf         , Gd^Fmw      , Gs^Fdw      , Gs^Fdw      , Ww          , Ww          , Ww          , Gs^Fdw      , Ww          , Ww          , Ww          , Wo          , Wo          , Wo          , Wo          , Wo          , Wo          , Ww          , Wwf         , Gs^Fdw      , Gd^Fmw      
Gll         , Gll^Fp      , Gll         , Gs^Fdw      , Gll         , Gll         , Gll         , Gll         , Gd^Fmw      , Gll         , Gll         , Gll^Fp      , Gll^Fp      , Gll^Fp      , Gll         , Gll         , Gll         , Gd^Fmw      , Gll         , Gs^Fdw      , Gd^Fmw      , Wwf         , Ww          , Ww          , Wwf         , Gd^Fmw      , Gll^Fp      , Gll^Fp      , Gs^Fdw      , Gd^Fmw      , Gd^Fmw      , Gd^Fmw      , Gs^Fdw      , Gs^Fdw      , Gd^Fmw      , Ww          , Ww          , Wo          , Wo          , Wo          , Wo          , Wo          , Ww          , Wwf         , Gd^Fmw      , Gd^Fmw      
Gll^Fp      , Gll         , Gs^Fdw      , Gll         , Gs^Fdw      , Gll         , Gll         , Gll         , Gll         , Gll         , Gll^Fp      , Gll         , Gll         , Gll         , Gll^Fp      , Gd^Fmw      , Gll         , Gll         , Gll^Fp      , Gll         , Gll^Fp      , Gd^Fmw      , Wwf         , Ww          , Ww          , Gd^Fmw      , Gll^Fp      , Gll         , Gll         , Gll^Fp      , Gll^Fp      , Gll^Fp      , Gll         , Gll^Fp      , Gd^Fmw      , Wwf         , Wwf         , Ww          , Ww          , Wo          , Ww          , Ww          , Wwf         , Gs^Fdw      , Gs^Fdw      , Gd^Fmw      
Gd^Fmw      , Gll^Fp      , Gs^Fdw      , Gll         , Gll^Fp      , Gll         , Gll^Fp      , Gll^Fp      , Gd^Fmw      , Gd^Fmw      , Gs^Fdw      , Gll^Fp      , Gll^Ve      , Gll         , Gd^Fmw      , Gll^Fp      , Gs^Fdw      , Gs^Fdw      , Gd^Fmw      , Gs^Fdw      , Gd^Fmw      , Gs^Fdw      , Gs^Fdw      , Wwf         , Wwf         , Ww          , Gd^Fmw      , Gll^Fp      , Gll^Fp      , Gll         , Gll         , Gll         , Gll         , Gll^Fp      , Gll^Fp      , Gd^Fmw      , Wwf         , Wwf         , Wwf         , Ww          , Wwf         , Wwf         , Gll^Fp      , Gs^Fdw      , Gd^Fmw      , Gs          
Gs          , Gd^Fmw      , Gd^Fmw      , Gs^Fdw      , Gll         , Gll         , Gs^Fdw      , Gs^Fdw      , Gs^Fdw      , Gs^Fdw      , Gd^Fmw      , Gs^Fdw      , Gd^Fmw      , Gd^Fmw      , Gs          , Gd^Fmw      , Gs^Fdw      , Gd^Fmw      , Gs          , Gd^Fmw      , Gs          , Gs^Fdw      , Gd^Fmw      , Gs^Fdw      , Wwf         , Ww          , Ww          , Gs^Fdw      , Gll^Fp      , Gll         , Gll^Fp      , Gll^Fp      , Gll         , Gll         , Gll         , Gs^Fdw      , Gs^Fdw      , Gd^Fmw      , Gd^Fmw      , Gd^Fmw      , Gll^Fp      , Gd^Fmw      , Gll^Fp      , Gs^Fdw      , Gd^Fmw      , Gs          
Gs          , Gd^Fmw      , Gs          , Gs^Fdw      , Gd^Fmw      , Gd^Fmw      , Gd^Fmw      , Gd^Fmw      , Gd^Fmw      , Gs^Fdw      , Gs          , Gd^Fmw      , Gs          , Gs          , 1 Ke        , Gs          , Re^Vct      , Gs          , Gg          , Gs          , Gs          , Gs^Fdw      , Gs^Fdw      , Gd^Fmw      , Gd^Fmw      , Ww          , Ww          , Gs^Fdw      , Gs^Fdw      , Gll         , Gs^Fdw      , Gs^Fdw      , Gs^Fdw      , Gll^Fp      , Gll^Fp      , Gll^Fp      , Gs^Fdw      , Gs^Fdw      , Gs^Fdw      , Gll^Fp      , Gs^Fdw      , Gs^Fdw      , Gs^Fdw      , Gd^Fmw      , Gs          , Gg          
Gg          , Gs          , Gg          , Gs          , Gs          , Gs          , Gg          , Gs          , Gs          , Gs          , Gg          , Gs          , Re^Vct      , Ce          , Ce          , Ce          , Ce          , Ce          , Gg          , Gg          , Gg          , Gs          , Gg          , Gg          , Gg          , Ww          , Ww          , Gd^Fmw      , Gd^Fmw      , Gd^Fmw      , Gs          , Gd^Fmw      , Gd^Fmw      , Gd^Fmw      , Gd^Fmw      , Gd^Fmw      , Gs          , Gd^Fmw      , Gd^Fmw      , Gd^Fmw      , Gd^Fmw      , Gd^Fmw      , Gs          , Gd^Fmw      , Gs          , Gg          
Gg          , Gg          , Gg          , Gg          , Gg          , Gg          , Gg          , Gg          , Gg          , Gg          , Gg          , Gg          , Gg          , Gg          , Gg          , Re^Vct      , Gg          , Re^Vct      , Gg          , Gg          , Gg          , Gg          , Gg          , Gg          , Gg          , Ww          , Ww          , Gg          , Gg          , Gs          , Gg          , Gg          , Gs          , Gs          , Gg          , Gs          , Gg          , Gs          , Gg          , Gs          , Gs          , Gs          , Gg          , Gs          , Gg          , Gg          
Gg          , Gg          , Gg          , Gg          , Gg          , Gg          , Gg          , Gg          , Gg          , Gg          , Gg          , Gg          , Gg          , Gg          , Gg          , Gg          , Gg          , Gg          , Gg          , Gg          , Gg          , Gg          , Gg          , Gg          , Gg          , Ww          , Ww          , Gg          , Gg          , Gg          , Gg          , Gg          , Gg          , Gg          , Gg          , Gg          , Gg          , Gg          , Gg          , Gg          , Gg          , Gg          , Gg          , Gg          , Gg          , Gg          
