border_size=1
usage=map

Xos         , Xos         , Xos         , Xos         , Xos         , Xos         , Xos         , Xos         , Xos         , Xos         , Xos         , Xos         , Xos         , Xos         , Xos         , Xos         , Xos         , Xos         , Xos         , Xos         , Xos         , Xos         , Xos         
Xos         , Xos         , Xos         , Xos         , Xos         , Xos         , Xos         , Xos         , Xos         , Xos         , Xol         , Xos         , Xol         , Xos         , Xos         , Xos         , Xos         , Xos         , Xos         , Xos         , Xos         , Xos         , Xos         
Xos         , Xos         , Xol         , Xol         , Urb         , Xol         , Xol         , Xol         , Cud         , Xol         , Cud         , Cud         , Cud         , Xol         , Cud         , Xol         , Xol         , Xol         , Urb         , Xol         , Xol         , Xos         , Xos         
Xos         , Xos         , Urb         , Urb         , Mm          , Urb         , Urb         , Cud         , Urb         , Urb         , Uu          , 3 Kud^Ii    , Uu          , Urb         , Urb         , Cud         , Urb         , Urb         , Ww          , Urb         , Urb         , Xos         , Xos         
Xos         , Xos         , Urb         , Mm          , Hh^Ii       , Mm          , Urb         , Urb         , Xos         , Urb         , Urb         , Uu          , Urb         , Urb         , Xos         , Urb         , Urb         , Ww          , Wwr^Ii      , Ww          , Urb         , Xos         , Xos         
Xos         , Xos         , Urb         , Mm          , Mm          , Mm          , Urb         , Xos         , Xol         , Xol         , Urb         , Urb         , Urb         , Xol         , Xol         , Xos         , Urb         , Ww          , Ww          , Ww          , Urb         , Xos         , Xos         
Xos         , Xos         , Xol         , Urb         , Urb         , Urb         , Urb         , Urb         , Urb         , Urb         , Urb         , Urb         , Urb         , Urb         , Urb         , Urb         , Urb         , Urb         , Urb         , Urb         , Xos         , Xos         , Xos         
Xos         , Xos         , Urb         , Urb         , Qlf         , Urb         , Urb         , Urb         , Urb         , Urb         , Urb         , Urb         , Urb         , Urb         , Urb         , Urb         , Urb         , Urb         , Qxu         , Urb         , Urb         , Xos         , Xos         
Xos         , Xos         , Urb         , Qlf         , Uh^Ii       , Qlf         , Urb         , Urb         , Xos         , Xos         , Ur          , Ur          , Ur          , Xos         , Xos         , Urb         , Urb         , Qxu         , Rd^Ii       , Qxu         , Urb         , Xos         , Xos         
Xos         , Xos         , Xos         , Qlf         , Qlf         , Qlf         , Xos         , Xos         , Xos         , Xos         , Iwr         , 2 Iwr       , Iwr         , Xos         , Xos         , Xos         , Xos         , Qxu         , Qxu         , Qxu         , Xos         , Xos         , Xos         
Xos         , Xos         , Xos         , Xos         , Xos         , Xos         , Xos         , Xos         , Xos         , Xos         , Iwr         , 1 Iwr       , Iwr         , Xos         , Xos         , Xos         , Xos         , Xos         , Xos         , Xos         , Xos         , Xos         , Xos         
Xos         , Xos         , Xos         , Xos         , Xos         , Xos         , Xos         , Xos         , Xos         , Xos         , Iwr         , Iwr         , Iwr         , Xos         , Xos         , Xos         , Xos         , Xos         , Xos         , Xos         , Xos         , Xos         , Xos         
