border_size=1
usage=map

Mm          , Mm          , Ww          , Ww          , Ww          , Ww          , Wo          , Wo          , Ww          , Ww          , Ww          , Wo          , Ww          , Ww          , Ww          , Gg          , Gg          , Gg          , Gg          , Gg          , Gg          , Gg          , Gg          , Gg          , Gg          , Gg          , Gg          
Ww          , Ww          , Wo          , Wo          , Ww          , Wo          , Ww          , Ww          , Wwf         , Wwf         , Qxu         , Ww          , Ww          , Wo          , Wo          , Ww          , Ww          , Gg          , Gg          , Gg          , Gg          , Gg          , Gg          , Gg          , Gg          , Gg          , Gg          
Ww          , Wo          , Ww          , Ww          , Mm          , Ww          , Chr         , Gg          , Rp          , Chr         , Mm          , Qxu         , Mm          , Ww          , Wo          , Ww          , Ww          , Gg          , Gg          , Gg          , Gg          , Gg          , Gg          , Gg          , Gg          , Gg          , Gg          
Wo          , Ww          , Wwf         , Mm          , Qxu         , Qxu         , Rp          , Rp          , Gg^Dr       , Rp          , Rp          , Qxu         , Rp          , Ww          , Ww          , Ww          , Ww          , Gg          , Gg          , Gg          , Gg          , Gg          , Gg          , Gg          , Gg          , Gg          , Gg          
Ww          , Ww          , Rp          , Chr         , Gg          , Rp^Vhcr     , Rp          , Gg^Dr       , 1 Rr^Dr     , Gg^Dr       , Rp^Vhcr     , Rp          , Qxu         , Chr         , Ww          , Wo          , Ww          , Gg          , Gg          , Gg          , Gg          , Gg          , Gg          , Gg          , Gg          , Gg          , Gg          
Wwf         , Wwf         , Chr         , Rp          , Rp          , Rp          , Rp          , Gg^Dr       , Chr^Dr      , Chr^Dr      , Rp          , Qxu         , Mm          , Mm          , Ww          , Wo          , Ww          , Gg          , Gg          , Gg          , Gg          , Gg          , Gg          , Gg          , Gg          , Gg          , Gg          
Wwf         , Wwf         , Ww          , Chr         , Qxu         , Rp^Vhcr     , Ch          , Rp          , Qxu         , Rp          , Wwf         , Hh          , Wwf         , Hh          , Ww          , Wo          , Ww          , Gg          , Gg          , Gg          , Gg          , Gg          , Gg          , Gg          , Gg          , Gg          , Gg          
Ww          , Wo          , Ww          , Mm          , Mm          , Qxu         , Wwf         , Wwf         , Wwf         , Qxu         , Wwf         , Wwf         , Wwf         , Ww          , Ww          , Wo          , Ww          , Gg          , Gg          , Gg          , Gg          , Gg          , Gg          , Gg          , Gg          , Gg          , Gg          
Ww          , Wo          , Wo          , Ww          , Ww          , Wwf         , Wwf         , Wwf         , Qxu         , Qxu         , Gg          , Wwf         , Rp^Vhcr     , Chr         , Chr         , Ww          , Wo          , Ww          , Gg          , Gg          , Gg          , 2 Gg        , Gg          , Gg          , Gg          , Gg          , Gg          
Ww          , Wo          , Ww          , Ww          , Ww          , Ww          , Chr         , Rp^Vhcr     , Rp          , Gg          , Rp^Vhcr     , Rp          , Rp          , Rp          , Rp          , Ww          , Wo          , Ww          , Gg          , Gg          , Gg          , Gg          , Gg          , Gg          , Gg          , Gg          , Gg          
Gg          , Ww          , Ww          , Wo          , Wo          , Ww          , Ww          , Gg          , Rp          , Qxu         , Qxu         , Qxu         , Rp          , Gg          , Chr         , Wwf         , Wwf         , Wwf         , Gg          , Gg          , Gg          , Gg          , Gg          , Gg          , Gg          , Gg          , Gg          
Gg          , Gg          , Gg          , Ww          , Ww          , Wo          , Wwf         , Wwf         , Ww          , Chr         , Ww          , Rp          , Chr         , Gg          , Ww          , Ww          , Wo          , Wwf         , Gg          , Gg          , Gg          , Gg          , Gg          , Gg          , Gg          , Gg          , Gg          
Gg          , Gg          , Gg          , Gg          , Gg          , Wwf         , Wwf         , Wo          , Wo          , Ww          , Wo          , Wwf         , Ww          , Ww          , Wo          , Wo          , Ww          , Ww          , Gg          , Gg          , Gg          , Gg          , Gg          , Gg          , Gg          , Gg          , Gg          
Gg          , Gg          , Gg          , Gg          , Gg          , Gg          , Gg          , Ww          , Wo          , Wo          , Ww          , Wwf         , Wwf         , Ww          , Ww          , Ww          , Gg          , Gg          , Gg          , Gg          , Gg          , Gg          , Gg          , Gg          , Gg          , Gg          , Gg          
Gg          , Gg          , Gg          , Gg          , Gg          , Gg          , Gg          , Ww          , Wo          , Ww          , Gg          , Gg          , Gg          , Gg          , Gg          , Gg          , Gg          , Gg          , Gg          , Gg          , Gg          , Gg          , Gg          , Gg          , Gg          , Gg          , Gg          
Gg          , Gg          , Gg          , Gg          , Gg          , Gg          , Gg          , Ww          , Wo          , Ww          , Gg          , Gg          , Gg          , Gg          , Gg          , Gg          , Gg          , Gg          , Gg          , Gg          , Gg          , Gg          , Gg          , Gg          , Gg          , Gg          , Gg          
Gg          , Gg          , Gg          , Gg          , Gg          , Gg          , Gg          , Wwt         , Wwt         , Ww          , Gg          , Gg          , Gg          , Gg          , Gg          , Gg          , Gg          , Gg          , Gg          , Gg          , Gg          , Gg          , Gg          , Gg          , Gg          , Gg          , Gg          
Gg          , Gg          , Gg          , Gg          , Gg          , Gg          , Gg          , Wwf         , Wwf         , Wwf         , Gg          , Gg          , Gg          , Gg          , Gg          , Gg          , Gg          , Gg          , Gg          , Gg          , Gg          , Gg          , Gg          , Gg          , Gg          , Gg          , Gg          
Gg          , Gg          , Gg          , Gg          , Gg          , Gg          , Gg          , Wwf         , Wwf         , Wwf         , Gg          , Gg          , Gg          , Gg          , Gg          , Gg          , Gg          , Gg          , Gg          , Gg          , Gg          , Gg          , Gg          , Gg          , Gg          , Gg          , Gg          
