border_size=1
usage=map

Dd          , Dd          , Dd          , Dd          , Dd          , Dd          , Dd          , Dd          , Dd          , Dd          , Dd          , Dd          , Dd          , Dd          , Dd          , Dd^Edp      , Dd          , Dd          , Dd          , Dd^Esd      , Dd          , Dd          , Dd          , Dd^Edpp     , Dd          , Dd          , Dd          , Dd          , Dd          , Dd          , Dd^Edp      , Dd          , Dd          , Dd          , Dd          , Dd^Es       , Dd          , Dd          , Dd^Edpp     
Dd          , Dd          , Dd^Vdt      , Dd          , Dd          , Dd          , Dd          , Dd          , Dd          , Dd          , Dd^Vdt      , Dd          , Dd          , Dd          , Dd^Es       , Dd          , Dd          , Dd          , Hd          , Dd          , Dd^Edp      , Dd          , Dd          , Dd          , Dd          , Dd          , Dd          , Dd          , Dd          , Dd          , Dd          , Dd          , Dd          , Dd          , Dd          , Dd          , Dd^Edpp     , Dd^Edp      , Dd          
Dd          , Dd          , Dd          , Dd^Es       , Ce          , Ce          , Md          , Hd          , Hd          , Dd          , Dd          , Dd          , Dd          , Dd          , Dd          , Dd          , Dd          , Hd          , Gs          , Gs^Ft       , Hd          , Dd          , Dd          , Dd          , Dd^Do       , Dd          , Dd          , Dd          , Hd          , Dd^Edpp     , Dd          , Dd          , Dd          , Dd          , Dd^Edp      , Dd          , Dd          , Dd          , Dd^Edp      
Dd          , Dd          , Dd          , Ce          , Ce          , Ce          , Ce          , Md          , Hd^Dr       , Dd          , Dd          , Dd^Esd      , Dd          , Dd          , Dd          , Dd          , Dd          , Gs          , Gs^Ft       , Gs^Ft       , Gs          , Hd          , Dd          , Dd          , Dd          , Dd          , Dd          , Dd          , Gs^Ft       , Hd          , Dd          , Dd^Esd      , Hd          , Dd          , Gs^Vda      , Dd          , Dd          , Dd          , Dd          
Dd          , Dd          , Dd          , Hd          , Md          , 3 Ke        , Hd          , Md          , Md          , Dd          , Dd          , Dd^Vdt      , Dd          , Dd^Edpp     , Dd          , Dd          , Dd          , Hd          , Gs^Ft       , Gs^Vda      , Gs^Ft       , Hd          , Dd          , Dd^Es       , Dd          , Dd          , Gs          , Gs^Ft       , Gs^Vda      , Hd          , Dd          , Dd          , Hd          , Gs^Ft       , Gs^Ft       , Hd          , Hd          , Dd          , Dd          
Dd          , Dd          , Dd          , Hd          , Md^Xm       , Hd          , Md          , Md          , Dd          , Dd          , Dd          , Dd          , Dd          , Dd^Edp      , Dd          , Dd          , Dd          , Hd          , Hd          , Gs^Ft       , Dd          , Dd          , Dd^Edpp     , Dd          , Dd          , Hd          , Gs          , Gs^Ft       , Gs          , Gs^Ft       , Hd          , Dd          , Dd          , Gs          , Gs^Ft       , Hd          , Hd          , Dd          , Dd          
Dd          , Dd          , Dd          , Md          , Md          , Md          , Hd          , Hd          , Dd          , Dd^Vdt      , Dd          , Dd          , Dd          , Dd^Es       , Gs^Ft       , Dd          , Dd          , Dd          , Dd          , Dd          , Dd          , Dd          , Dd^Es       , Dd          , Dd^Edpp     , Hd          , Hd          , Gs          , Gs^Ft       , Gs^Ft       , Hd          , Dd          , Dd          , Dd          , Dd          , Dd^Es       , Dd          , Dd          , Dd          
Dd^Es       , Dd          , Dd          , Dd          , Dd^Es       , Dd          , Dd          , Dd          , Dd^Edp      , Dd          , Dd          , Dd          , Gs          , Gs          , Gs^Vda      , Hd          , Hd          , Dd          , Dd          , Dd          , Dd^Esd      , Dd          , Dd          , Dd^Edpp     , Dd          , Hd          , Dd          , Dd^Edpp     , Dd          , Hd          , Dd          , Dd          , Dd^Edpp     , Dd          , Dd          , Dd          , Dd^Esd      , Dd          , Dd          
Dd          , Dd          , Dd^Vdt      , Dd          , Dd          , Dd          , Dd^Vdt      , Dd          , Dd          , Dd          , Dd          , Dd          , Gs          , Gs^Ft       , Gs^Ft       , Gs          , Hd          , Dd          , Dd          , Dd          , Dd^Esd      , Dd          , Dd          , Dd^Esd      , Dd          , Dd          , Dd          , Dd          , Dd          , Dd          , Dd          , Dd^Es       , Dd          , Dd          , Dd^Edp      , Dd          , Dd          , Dd          , Dd^Es       
Dd          , Dd          , Dd          , Dd          , Dd          , Dd          , Dd          , Dd          , Dd          , Dd          , Dd          , Dd          , Hd          , Gs^Ft       , Hd          , Dd^Es       , Dd          , Dd          , Dd          , Dd          , Dd          , Dd^Do       , Dd          , Dd          , Dd^Edp      , Dd^Esd      , Dd          , Dd          , Dd          , Dd          , Dd          , Dd          , Dd^Esd      , Dd^Esd      , Dd          , Dd          , Dd          , Dd          , Dd          
Dd          , Dd          , Dd          , Dd          , Hd          , Dd          , Gs^Ft       , Dd          , Dd          , Dd          , Dd          , Dd          , Dd          , Hd          , Dd          , Dd          , Dd          , Dd          , Dd          , Dd          , Dd^Edp      , Dd          , Dd          , Dd^Edp      , Dd          , Dd          , Dd          , Dd          , Dd^Edp      , Dd          , Dd^Vda      , Dd          , Dd^Esd      , Dd          , Dd^Es       , Dd          , Dd          , Dd^Esd      , Dd          
Dd          , Dd          , Dd          , Hd          , Gs          , Gs          , Gs^Vda      , Gs^Ft       , Dd          , Dd          , Dd^Do       , Dd          , Dd          , Dd          , Dd          , Dd          , Dd          , Dd          , Dd          , Dd          , Gs^Ft       , Dd          , Dd          , Dd          , Dd^Edpp     , Dd^Edp      , Dd^Edp      , Dd          , Dd          , Dd          , Dd          , Dd          , Gs^Ft       , Dd          , Dd          , Dd          , Dd          , Dd          , Dd          
Dd          , Dd          , Dd          , Hd          , Gs^Ft       , Gs^Ft       , Gs^Ft       , Gs^Ft       , Dd          , Dd          , Dd          , Dd          , Dd          , Dd          , Dd          , Dd^Edp      , Dd          , Dd          , Gs          , Gs^Vda      , Gs^Ft       , Hd          , Dd          , Dd          , Dd          , Dd          , Gs          , Gs          , Gs^Ft       , Cd          , Gs          , Gs^Ft       , Gs^Ft       , Dd          , Dd          , Dd          , Dd          , Dd          , Dd          
Dd          , Dd          , Dd          , Dd          , Dd          , Hd          , Hd          , Hd          , Dd          , Dd          , Dd          , Dd^Esd      , Dd          , Dd          , Dd          , Dd          , Dd          , Dd          , Dd          , Gs^Ft       , Hd          , Hd          , Dd          , Dd          , Dd          , Dd          , Gs^Ft       , Gs^Ft       , Ww          , Gs^Ft       , Ww          , Gs          , Gs          , Cd          , Dd          , Dd          , Dd          , Dd          , Dd          
Dd          , Dd          , Dd          , Dd          , Dd          , Dd          , Dd          , Dd          , Dd          , Dd          , Dd          , Dd          , Dd          , Hd          , Hd          , Dd          , Dd^Es       , Dd          , Dd          , Dd^Esd      , Dd          , Dd          , Dd          , Dd          , Dd^Edpp     , Dd          , Gs          , Ww          , Wo          , Ww          , Ww          , Gs^Ft       , Gs^Ft       , Dd^Edpp     , Dd^Es       , Dd^Esd      , Dd          , Dd^Es       , Dd          
Dd          , Dd          , Dd^Esd      , Dd^Do       , Dd          , Dd          , Dd          , Dd          , Dd          , Dd          , Dd          , Dd          , Gs^Ft       , Gs^Ft       , Hd          , Dd          , Dd          , Dd          , Dd          , Dd          , Dd^Esd      , Dd          , Dd          , Dd^Vda      , Dd^Edpp     , Cd          , Gs^Ft       , Ww          , Ww          , Wo          , Ww          , Ww          , Gs^Ft       , Dd          , Dd^Vda      , Dd          , Dd          , Dd          , Dd          
Dd          , Dd          , Dd          , Dd          , Dd          , Dd          , Dd^Edpp     , Dd          , Dd          , Dd          , Dd          , Dd          , Gs^Ft       , Gs^Vda      , Gs^Ft       , Dd          , Dd          , Dd          , Dd^Esd      , Dd          , Dd          , Dd          , Dd          , Dd          , Dd          , Gs          , Gs          , Gs^Ft       , Gs^Ft       , Ww          , Gs^Ft       , Gs          , Cd          , Dd          , Dd^Es       , Dd          , Dd^Edp      , Dd^Edpp     , Dd^Edp      
Dd          , Dd          , Dd          , Dd          , Dd          , Dd          , Hd          , Dd          , Hd          , Dd          , Dd          , Dd          , Hd          , Gs^Ft       , Hd          , Gs^Ft       , Dd          , Dd          , Dd          , Dd^Esd      , Dd^Edp      , Dd          , Dd          , Dd          , Dd^Edpp     , Dd^Esd      , Dd          , Gs^Ft       , Cd          , Gs          , Gs^Ft       , Gs^Ft       , Dd          , Dd          , Dd          , Dd          , Dd          , Dd          , Dd          
Dd          , Dd          , Dd          , Dd          , Dd          , Hd          , Gs          , Gs^Ft       , Gs^Ft       , Hd          , Dd          , Dd          , Dd^Edp      , Hd          , Dd          , Dd          , Dd^Edpp     , Dd          , Dd          , Dd          , Dd^Edp      , Dd          , Dd          , Dd^Vda      , Dd          , Dd          , Dd          , Dd^Edp      , Cd          , 2 Kd        , Cd          , Dd          , Dd          , Dd^Esd      , Dd          , Dd^Esd      , Dd          , Dd          , Dd          
Dd          , Dd          , Dd          , Dd          , Hd          , Gs^Ft       , Gs          , Gs^Vda      , Gs^Ft       , Hd          , Dd          , Dd          , Dd          , Dd          , Dd          , Dd          , Dd          , Dd          , Dd          , Dd^Esd      , Dd          , Dd          , Dd          , Dd          , Dd          , Dd^Edp      , Dd          , Dd          , Cd          , Cd          , Cd          , Dd^Esd      , Dd^Vda      , Dd^Esd      , Dd^Esd      , Dd^Vdt      , Dd          , Dd          , Dd          
Dd          , Dd          , Dd          , Dd          , Hd          , Gs^Ft       , Gs^Ft       , Gs          , Gs^Ft       , Dd^Edp      , Dd          , Dd          , Dd          , Dd          , Dd          , Dd          , Dd          , Dd          , Dd          , Dd          , Dd          , Dd          , Dd          , Dd          , Dd          , Dd^Es       , Dd^Esd      , Dd^Vda      , Dd          , Dd^Edp      , Dd          , Dd          , Dd^Esd      , Dd          , Dd          , Dd          , Dd          , Dd          , Dd          
Dd          , Dd          , Dd          , Dd          , Dd          , Hd          , Dd          , Dd          , Dd          , Dd          , Dd          , Dd^Es       , Dd          , Dd          , Dd          , Dd          , Dd          , Dd          , Dd          , Dd          , Dd          , Dd          , Dd          , Dd^Edp      , Dd          , Dd^Edp      , Dd          , Dd^Esd      , Dd^Edp      , Dd          , Dd^Edpp     , Dd^Es       , Dd          , Dd          , 1 Ke        , Ce          , Dd          , Dd^Vdt      , Dd          
Dd          , Dd          , Dd          , Dd          , Dd          , Dd          , Dd          , Dd          , Dd          , Dd          , Dd          , Dd          , Dd          , Dd^Do       , Dd          , Dd          , Dd          , Dd          , Dd^Edpp     , Dd          , Dd          , Dd^Es       , Dd          , Dd          , Dd          , Dd          , Dd^Edp      , Dd^Edpp     , Dd          , Dd          , Dd          , Dd          , Dd          , Ce          , Ce          , Ce          , Dd          , Dd          , Dd          
Dd          , Dd          , Dd          , Dd^Es       , Dd          , Dd          , Dd^Edp      , Dd          , Dd          , Dd          , Dd          , Dd          , Dd          , Dd          , Dd^Esd      , Dd          , Dd          , Dd          , Dd          , Dd^Edp      , Dd          , Dd          , Dd          , Dd          , Dd          , Dd          , Dd^Es       , Dd^Edpp     , Dd          , Dd^Esd      , Dd          , Dd^Vdt      , Dd          , Dd          , Dd          , Dd^Edpp     , Dd          , Dd^Edp      , Dd          
Dd          , Dd          , Dd          , Dd          , Dd          , Dd          , Dd          , Dd          , Dd^Es       , Dd          , Dd          , Dd          , Dd          , Dd          , Dd^Esd      , Dd          , Dd          , Dd          , Dd          , Dd          , Dd          , Dd          , Dd          , Dd          , Dd          , Dd^Esd      , Dd          , Dd          , Dd          , Dd          , Dd          , Dd          , Dd          , Dd          , Dd^Es       , Dd          , Dd^Esd      , Dd          , Dd          
