border_size=1
usage=map

Aa^Fma      , Gd^Fmw      , Aa^Fma      , Aa^Fpa      , Gd^Fmw      , Gd^Fmw      , Aa          , Aa^Fpa      , Gd^Fmw      , Gd^Fmw      , Gd^Fmw      , Ai          , Wo          , Ai          , Gd^Fmw      , Gs^Fdw      , Gd^Fmw      , Gd^Fmw      , Aa^Fma      , Aa^Fpa      , Gd^Fmw      , Gd^Fmw      , Aa^Fma      , Aa^Fma      , Gd^Fmw      , Aa^Fpa      , Gd^Fmw      , Aa^Fma      , Gd^Fmw      , Gs^Fdw      , Aa^Fma      , Aa^Fpa      , Aa^Fpa      , Gd^Fmw      , Gd^Fmw      , Gd^Fmw      , Gd^Fmw      , Gd^Fmw      , Gd^Fmw      , Aa^Fpa      , Gs^Fdw      , Gd^Fmw      , Gd^Fmw      , Aa^Fpa      , Aa^Fpa      , Gd^Fmw      
Gd^Fmw      , Gd^Fmw      , Gd^Fmw      , Aa^Fpa      , Gd^Fmw      , Gd^Fmw      , Aa          , Aa^Fpa      , Aa^Fda      , Aa^Fma      , Gs^Fdw      , Ai          , Wo          , Ai          , Gd^Fmw      , Aa^Fpa      , Aa^Fma      , Gd^Fmw      , Aa^Fpa      , Gd^Fmw      , Aa^Fpa      , Aa^Fpa      , Aa^Fpa      , Gd^Fmw      , Aa^Fma      , Gd^Fmw      , Aa^Fda      , Gd^Fmw      , Gd^Fmw      , Gd^Fmw      , Gd^Fmw      , Gd^Fmw      , Gd^Fmw      , Ha          , Gs^Fdw      , Gd^Fmw      , Gs^Fdw      , Gd^Fmw      , Gd^Fmw      , Gd^Fmw      , Gd^Fmw      , Gd^Fmw      , Gd^Fmw      , Gd^Fmw      , Gd^Fmw      , Gd^Fmw      
Gd^Fmw      , Aa^Fma      , Aa^Fma      , Aa^Fda      , Cea         , Cea         , Cea         , Gd^Fmw      , Gd^Fmw      , Gd^Fmw      , Gd^Fmw      , Ai          , Ai          , Ai          , Ai          , Gd^Fmw      , Aa^Fda      , Gd^Fmw      , Aa^Fma      , Aa^Fpa      , Gd^Fmw      , Gd^Fmw      , Gd^Fmw      , Gd^Fmw      , Aa^Fma      , Gd^Fmw      , Gs^Fdw      , Gd^Fmw      , Aa^Fpa      , Aa^Fma      , Gd^Fmw      , Gd^Fmw      , Gs^Fdw      , Ha          , Ha          , Gd^Fmw      , Aa^Fpa      , Aa^Fpa      , Gd^Fmw      , Gd^Fmw      , Aa^Fma      , Aa^Fpa      , Gd^Fmw      , Gd^Fmw      , Gd^Fmw      , Aa^Fma      
Aa^Fma      , Aa^Fda      , Gd          , Gd^Fmw      , Cea         , 1 Kea       , Cea         , Aa          , Gd^Fmw      , Gd^Fmw      , Gd^Fmw      , Ai          , Wo          , Wo          , Ai          , Aa^Fma      , Aa^Fma      , Gd^Fmw      , Aa^Fda      , Gd^Fmw      , Gd^Fmw      , Gd^Fmw      , Aa^Fda      , Aa^Fma      , Gd^Fmw      , Aa^Fpa      , Gd^Fmw      , Gd^Fmw      , Aa^Fpa      , Gd^Fmw      , Gd^Fmw      , Gd^Fmw      , Aa^Fpa      , Gd^Fmw      , Aa^Fpa      , Ha          , Ha          , Ha          , Ha          , Gd^Fmw      , Aa^Fpa      , Aa^Fpa      , Aa^Fma      , Gd^Fmw      , Aa^Fma      , Gd^Fmw      
Gd^Fmw      , Gd^Fmw      , Gd          , Gd          , Aa^Fda      , Cea         , Gs^Fdw      , Gd^Fmw      , Gd          , Aa^Fda      , Gd^Fmw      , Ai          , Wo          , Wo          , Ai          , Gd^Fmw      , Aa^Fma      , Aa^Fma      , Aa^Fpa      , Gd^Fmw      , Gd^Fmw      , Aa^Fma      , Ha          , Ha          , Ha          , Gs^Fdw      , Gd^Fmw      , Gd^Fmw      , Aa^Fpa      , Aa^Fpa      , Gd^Fmw      , Gd^Fmw      , Gd^Fmw      , Gd^Fmw      , Aa^Fma      , Gd^Fmw      , Gd^Fmw      , Ha          , Ha          , Ha          , Gd^Fmw      , Aa^Fma      , Aa^Fpa      , Gd^Fmw      , Aa^Fma      , Gd^Fmw      
Gd^Fmw      , Aa^Fma      , Gd          , Gd          , Aa^Fpa      , Gd^Fmw      , Aa^Fma      , Gd^Fmw      , Gd          , Gd          , Gs^Fdw      , Ai          , Ai          , Ai          , Aa^Fda      , Aa^Fma      , Aa^Fma      , Aa^Fma      , Aa^Fma      , Gd^Fmw      , Aa^Fma      , Ha          , Gd^Fmw      , Gs^Fdw      , Aa^Fma      , Gd^Fmw      , Aa^Fpa      , Aa^Fpa      , Aa^Vea      , Aa^Fma      , Gd          , Aa          , Gd          , Aa^Fpa      , Aa^Fma      , Gd^Fmw      , Gd^Fmw      , Gd^Fmw      , Gd^Fmw      , Ha          , Aa^Fma      , Gd^Fmw      , Gd^Fmw      , Aa^Fma      , Aa^Fma      , Gd^Fmw      
Aa^Fpa      , Gd^Fmw      , Gd^Fmw      , Aa^Fpa      , Aa^Vea      , Aa          , Aa          , Aa^Fda      , Gd^Fmw      , Gd^Fmw      , Ai          , Ai          , Wo          , Ai          , Aa^Fpa      , Aa^Fma      , Gd^Fmw      , Gd^Fmw      , Aa^Fpa      , Aa^Fma      , Gs^Fdw      , Ha          , Gd^Fmw      , Aa^Fpa      , Gd^Fmw      , Gd^Fmw      , Aa^Fda      , Gd^Fmw      , Gd          , Gd          , Cv          , Gd          , Cv          , Gd          , Gd          , Gd^Fmw      , Aa^Fpa      , Gd^Fmw      , Aa^Fma      , Gd^Fmw      , Gd^Fmw      , Gd^Fmw      , Gd^Fmw      , Gd^Fmw      , Gd^Fmw      , Gd^Fmw      
Aa^Fpa      , Aa^Fda      , Gd^Fmw      , Aa          , Aa          , Aa          , Aa^Fma      , Gd^Fmw      , Aa^Fpa      , Aa^Fpa      , Ai          , Wo          , Ai          , Ai          , Gd^Fmw      , Aa^Fpa      , Gd^Fmw      , Aa^Fpa      , Gd^Fmw      , Gd^Fmw      , Aa^Fpa      , Ha          , Ha          , Ha          , Gs^Fdw      , Aa^Fpa      , Aa^Fpa      , Aa          , Gd          , Aa^Vea      , Aa          , Cv          , Aa^Vea      , Gd          , Gd          , Aa^Vea      , Gd^Fmw      , Gd^Fmw      , Aa^Fma      , Aa^Fpa      , Aa^Fma      , Ha          , Gd^Fmw      , Gd^Fmw      , Gd^Fmw      , Aa^Fpa      
Aa^Fma      , Aa^Fma      , Gd^Fmw      , Aa          , Gd^Fmw      , Aa          , Gd^Fmw      , Aa^Fma      , Gd^Fmw      , Ai          , Wo          , Ai          , Ai          , Gd^Fmw      , Aa^Fma      , Gd^Fmw      , Gd^Fmw      , Gd^Fmw      , Aa^Fpa      , Gd^Fmw      , Ha          , Aa^Fpa      , Gd^Fmw      , Gd^Fmw      , Gd^Fmw      , Gd^Fmw      , Gd^Fmw      , Aa          , Gd          , Aa          , Cv          , 2 Kv        , Aa^Vea      , Gd          , Gd          , Aa          , Gd^Fmw      , Gd^Fmw      , Aa^Fma      , Aa^Fma      , Gd^Fmw      , Ha          , Gd^Fmw      , Gd^Fmw      , Gd^Fmw      , Gd^Fmw      
Gd^Fmw      , Aa^Fpa      , Aa^Fma      , Gd          , Gd          , Gd^Fmw      , Aa^Fma      , Gd          , Aa^Fda      , Ai          , Wo          , Ai          , Aa^Fda      , Aa^Fpa      , Aa^Fma      , Gd^Fmw      , Aa          , Gs^Fdw      , Aa          , Aa^Vea      , Gd^Fmw      , Aa          , Aa^Fma      , Aa^Fma      , Aa^Fma      , Aa^Fma      , Gd^Fmw      , Gd^Fmw      , Aa          , Gd          , Gd          , Cv          , Gd          , Gd          , Gd          , Gd^Fmw      , Gd^Fmw      , Gd^Fmw      , Gd^Fmw      , Aa^Fpa      , Ha          , Ha          , Gd^Fmw      , Gd^Fmw      , Aa^Fda      , Aa^Fpa      
Aa^Fda      , Aa^Fda      , Gd^Fmw      , Gd          , Aa^Fpa      , Gd^Fmw      , Gd          , Gd          , Gd^Fmw      , Ai          , Wo          , Ai          , Gd^Fmw      , Aa^Fma      , Gd^Fmw      , Aa^Fpa      , Aa          , Aa          , Gs^Fdw      , Aa          , Aa          , Gd^Fmw      , Aa^Fma      , Aa^Fpa      , Gd^Fmw      , Gd^Fmw      , Aa^Fma      , Gd^Fmw      , Aa^Fpa      , Aa          , Aa          , Gd          , Gd          , Gd          , Gd^Fmw      , Aa^Fma      , Gd^Fmw      , Gd^Fmw      , Gd^Fmw      , Aa^Fma      , Ha          , Ha          , Gd^Fmw      , Aa^Fma      , Gd^Fmw      , Gd^Fmw      
Aa^Fda      , Aa^Fpa      , Gd^Fmw      , Gd^Fmw      , Aa          , Aa          , Aa^Fma      , Aa^Fma      , Aa^Fpa      , Ai          , Ai          , Ai          , Gd^Fmw      , Aa^Fda      , Gd^Fmw      , Gd^Fmw      , Gd^Fmw      , Aa^Vea      , Aa          , Aa^Fpa      , Aa          , Aa          , Gd^Fmw      , Gd^Fmw      , Gd^Fmw      , Gd^Fmw      , Aa^Fpa      , Gd^Fmw      , Aa^Fma      , Aa^Fma      , Gd^Fmw      , Aa^Fda      , Aa^Fpa      , Gd^Fmw      , Gd^Fmw      , Gd^Fmw      , Ha          , Aa^Fma      , Ha          , Gd^Fmw      , Ha          , Gd^Fmw      , Aa^Fpa      , Aa^Fma      , Aa^Fpa      , Gd^Fmw      
Aa^Fma      , Gd^Fmw      , Gd^Fmw      , Gd          , Aa          , Gd^Fmw      , Aa^Fma      , Gd^Fmw      , Gd^Fmw      , Ai          , Wo          , Ai          , Aa^Fda      , Aa^Fpa      , Gs^Fdw      , Aa^Fpa      , Aa^Fma      , Gd^Fmw      , Aa^Fpa      , Gd^Fmw      , Gs^Fdw      , Aa^Fpa      , Aa^Fpa      , Gd^Fmw      , Aa^Fpa      , Aa^Fma      , Gd^Fmw      , Aa^Fma      , Gd^Fmw      , Aa^Fma      , Aa^Fma      , Gd^Fmw      , Gs^Fdw      , Aa^Fpa      , Aa^Fma      , Ha          , Gs^Fdw      , Ha          , Aa^Fpa      , Ha          , Aa^Fpa      , Gd^Fmw      , Aa^Fpa      , Gd^Fmw      , Aa^Fma      , Aa^Fpa      
Gd^Fmw      , Aa^Fma      , Gd          , Gd          , Aa          , Aa          , Aa^Fma      , Gd          , Aa^Fpa      , Ai          , Wo          , Ai          , Aa^Fpa      , Aa^Fda      , Gd^Fmw      , Gd^Fmw      , Gd^Fmw      , Aa^Fpa      , Gd^Fmw      , Gd^Fmw      , Ha          , Gd^Fmw      , Ha          , Aa^Fma      , Ha          , Gd^Fmw      , Gd^Fmw      , Gd^Fmw      , Aa^Fpa      , Gd^Fmw      , Gd^Fmw      , Gd^Fmw      , Aa^Fma      , Aa^Fpa      , Gd^Fmw      , Gd^Fmw      , Gd^Fmw      , Gd^Fmw      , Gs^Fdw      , Gs^Fdw      , Gs^Fdw      , Gd^Fmw      , Gd^Fmw      , Gd^Fmw      , Gd^Fmw      , Gd^Fmw      
Aa^Fma      , Gd^Fmw      , Aa^Fda      , Aa          , Gd^Fmw      , Gd^Fmw      , Gd          , Gd          , Aa^Fma      , Ai          , Ai          , Ai          , Ai          , Gd^Fmw      , Aa^Fpa      , Gd^Fmw      , Aa^Fma      , Gd^Fmw      , Aa^Fma      , Gd^Fmw      , Ha          , Ha          , Aa^Fpa      , Aa^Fpa      , Gd^Fmw      , Aa^Fpa      , Gd^Fmw      , Aa^Fma      , Gs^Fdw      , Gs^Fdw      , Gd^Fmw      , Aa^Fma      , Aa^Fda      , Gd^Fmw      , Gs^Fdw      , Aa^Fma      , Aa^Fma      , Gd^Fmw      , Gd^Fmw      , Gd^Fmw      , Gd^Fmw      , Aa^Fpa      , Gd^Fmw      , Aa^Fma      , Gd^Fmw      , Gd^Fmw      
Gs^Fdw      , Aa^Fda      , Aa^Fpa      , Gs^Fdw      , Aa          , Aa          , Aa^Fda      , Gd^Fmw      , Gd^Fmw      , Ai          , Ai          , Wo          , Wo          , Ai          , Gd^Fmw      , Gd^Fmw      , Gd^Fmw      , Gd^Fmw      , Gd^Fmw      , Aa^Fma      , Ha          , Gd^Fmw      , Aa^Fpa      , Gd^Fmw      , Ha          , Aa^Vea      , Aa          , Aa^Fma      , Gd^Fmw      , Aa^Fda      , Gd^Fmw      , Gd^Fmw      , Aa^Fpa      , Aa^Fma      , Aa^Fma      , Gd^Fmw      , Aa^Fda      , Gd^Fmw      , Aa^Fma      , Aa^Fpa      , Gd^Fmw      , Aa^Fda      , Aa^Fma      , Gd^Fmw      , Gd^Fmw      , Aa^Fpa      
Aa^Fpa      , Aa^Fpa      , Aa^Fda      , Gd^Fmw      , Aa^Fpa      , Aa^Vea      , Gd^Fmw      , Aa^Fma      , Gd          , Gd          , Aa^Fma      , Ai          , Ai          , Ai          , Ai          , Aa^Fpa      , Gd^Fmw      , Gd^Fmw      , Aa^Fpa      , Gd^Fmw      , Aa^Fpa      , Ha          , Ha          , Ha          , Aa          , Gd^Fmw      , Aa^Fpa      , Gs^Fdw      , Aa          , Aa          , Aa          , Gd^Fmw      , Gd^Fmw      , Gd^Fmw      , Aa^Fpa      , Aa^Fma      , Gd^Fmw      , Aa^Fpa      , Gd^Fmw      , Aa^Fma      , Aa^Fpa      , Gd^Fmw      , Gd^Fmw      , Gd^Fmw      , Gd^Fmw      , Gd^Fmw      
Gd^Fmw      , Aa^Fma      , Aa^Fpa      , Aa          , Gd          , Aa          , Aa^Fma      , Aa^Fda      , Gd^Fmw      , Gd          , Aa^Fma      , Ai          , Ai          , Wo          , Wo          , Ai          , Ai          , Ai          , Ai          , Gd^Fmw      , Gd^Fmw      , Gd^Fmw      , Aa^Fma      , Gs^Fdw      , Gd^Fmw      , Aa          , Gd^Fmw      , Aa          , Aa^Fma      , Aa          , Gd^Fmw      , Aa^Fpa      , Gd^Fmw      , Gd^Fmw      , Aa          , Gd^Fmw      , Aa          , Aa^Fpa      , Aa          , Aa^Fma      , Gd^Fmw      , Aa^Fpa      , Aa^Fpa      , Aa^Fda      , Aa^Fpa      , Aa^Fma      
Gd^Fmw      , Gd^Fmw      , Gd^Fmw      , Aa^Fma      , Aa^Fpa      , Gd          , Aa          , Aa          , Gd          , Aa^Fpa      , Aa^Fda      , Aa^Fma      , Aa^Fma      , Ai          , Ai          , Wo          , Ai          , Wo          , Wo          , Ai          , Ai          , Aa          , Aa          , Gs^Fdw      , Aa^Fpa      , Aa^Fpa      , Gd^Fmw      , Aa^Fma      , Aa^Fpa      , Gd^Fmw      , Aa^Fma      , Gd^Fmw      , Gd^Fmw      , Aa          , Aa          , Aa^Vea      , Aa          , Aa          , Gd^Fmw      , Aa          , Gd^Fmw      , Gd^Fmw      , Gd^Fmw      , Gd^Fmw      , Gd^Fmw      , Aa^Fda      
Aa^Fda      , Gd^Fmw      , Aa          , Aa^Fma      , Gs^Fdw      , Gd          , Aa^Fpa      , Aa          , Gd          , Gd          , Gd^Fmw      , Gd^Fmw      , Aa^Fda      , Gd^Fmw      , Aa          , Ai          , Ai          , Ai          , Ai          , Wo          , Ai          , Ai          , Ai          , Aa          , Ai          , Gd^Fmw      , Gd^Fmw      , Aa^Fma      , Gs^Fdw      , Gd^Fmw      , Gd^Fmw      , Gd^Fmw      , Gd^Fmw      , Aa          , Aa          , Gd^Fmw      , Gd^Fmw      , Aa          , Aa          , Gs^Fdw      , Gd^Fmw      , Aa^Fpa      , Gd^Fmw      , Gd^Fmw      , Gs^Fdw      , Gd^Fmw      
Gd^Fmw      , Gd^Fmw      , Gd          , Gd          , Gd          , Aa          , Aa          , Aa          , Aa^Fma      , Gd          , Aa^Vea      , Gd^Fmw      , Gd^Fmw      , Aa^Fma      , Aa          , Aa          , Aa          , Aa^Fpa      , Aa^Fpa      , Ai          , Ai          , Wo          , Wo          , Ai          , Wo          , Ai          , Ai          , Gd^Fmw      , Ai          , Aa^Fpa      , Gd^Fmw      , Gd^Fmw      , Aa^Fpa      , Aa^Fma      , Gd^Fmw      , Aa          , Aa^Fpa      , Aa          , Aa          , Aa^Fpa      , Gd^Fmw      , Gd^Fmw      , Gd^Fmw      , Gd^Fmw      , Gs^Fdw      , Aa^Fma      
Gd^Fmw      , Aa^Fma      , Aa^Fma      , Aa          , Aa^Fma      , Aa          , Aa          , Aa          , Aa^Fda      , Aa          , Aa          , Gd^Fmw      , Aa          , Gd^Fmw      , Gd^Fmw      , Aa          , Gd^Fmw      , Gd^Fmw      , Gd^Fmw      , Gd^Fmw      , Gd^Fmw      , Ai          , Ai          , Ai          , Ai          , Wo          , Wo          , Ai          , Wo          , Ai          , Ai          , Gd^Fmw      , Gd^Fmw      , Gd^Fmw      , Gd^Fmw      , Gd^Fmw      , Gd^Fmw      , Aa^Fma      , Gd^Fmw      , Gd^Fmw      , Gs^Fdw      , Gd^Fmw      , Gd^Fmw      , Aa^Fpa      , Aa^Fpa      , Gd^Fmw      
Ha          , Ha          , Ha          , Aa^Fma      , Gd^Fmw      , Gs^Fdw      , Gd^Fmw      , Aa^Fma      , Aa^Fpa      , Aa^Fpa      , Aa          , Aa          , Aa          , Aa          , Gd^Fmw      , Gd^Fmw      , Aa          , Gd^Fmw      , Aa^Fma      , Aa^Fma      , Gd^Fmw      , Gd^Fmw      , Gd^Fmw      , Aa^Fpa      , Aa^Fpa      , Ai          , Ai          , Ai          , Ai          , Wo          , Ai          , Ai          , Ai          , Aa^Fma      , Aa^Fma      , Gd^Fmw      , Gd^Fmw      , Gd^Fmw      , Aa          , Aa          , Aa          , Aa^Fma      , Gd^Fmw      , Gd^Fmw      , Aa^Fma      , Aa^Fpa      
Ms          , Ms^Xm       , Ms^Xm       , Ha          , Ha          , Aa^Fda      , Gd^Fmw      , Aa^Fpa      , Gd^Fmw      , Gd^Fmw      , Gd          , Gd          , Gd          , Gd          , Gd          , Gd          , Aa^Vea      , Aa          , Gd^Fmw      , Gd^Fmw      , Aa^Fda      , Gd^Fmw      , Aa^Fma      , Gd^Fmw      , Aa^Fpa      , Gd^Fmw      , Gd^Fmw      , Gd^Fmw      , Gd^Fmw      , Ai          , Ai          , Wo          , Wo          , Ai          , Ai          , Aa^Fma      , Aa^Fpa      , Aa          , Aa          , Aa^Fma      , Aa^Vea      , Gs^Fdw      , Aa^Fpa      , Aa^Fpa      , Gd^Fmw      , Aa^Fma      
Ms          , Ms          , Ms          , Ms^Xm       , Ms          , Ha          , Gd^Fmw      , Gd^Fmw      , Gd^Fmw      , Gd          , Aa^Vea      , Cea         , Cea         , Cea         , Cea         , Aa          , Aa          , Aa          , Cea         , Cea         , Cea         , Cea         , Aa          , Aa^Fma      , Gd^Fmw      , Aa^Fda      , Aa^Fpa      , Aa^Fma      , Aa^Fma      , Gd^Fmw      , Aa^Fpa      , Ai          , Ai          , Wo          , Ai          , Gd^Fmw      , Gd^Fmw      , Aa^Fpa      , Aa^Fpa      , Aa          , Aa          , Aa          , Gs^Fdw      , Gd^Fmw      , Gs^Fdw      , Aa^Fpa      
Ms          , Ms          , Ms^Xm       , Ms          , Ms          , Ms          , Ha          , Aa^Fpa      , Gd          , Aa          , Cea         , Cea         , 3 Kea       , Cea         , Cea         , Aa          , Aa          , Aa^Fma      , Cea         , 5 Kea       , Cea         , Cea         , Aa          , Aa^Vea      , Gd          , Gd^Fmw      , Gd^Fmw      , Gd^Fmw      , Gd^Fmw      , Gd^Fmw      , Aa^Fma      , Aa^Fma      , Ai          , Ai          , Wo          , Ai          , Ai          , Aa^Fda      , Gs^Fdw      , Gd^Fmw      , Gd^Fmw      , Gd^Fmw      , Aa^Fpa      , Aa^Fpa      , Gs^Fdw      , Gd^Fmw      
Ms          , Ms          , Ms^Xm       , Ms^Xm       , Ms^Xm       , Ms          , Ms          , Ha          , Gd^Fmw      , Aa          , Aa          , Cea         , Cea         , Cea         , Aa          , Aa          , Aa          , Gd^Fmw      , Gd^Fmw      , Cea         , Aa^Fma      , Aa^Fma      , Aa          , Aa          , Gd          , Gd          , Gd          , Gd^Fmw      , Gd^Fmw      , Aa^Fpa      , Gd^Fmw      , Gd^Fmw      , Aa^Fma      , Ai          , Ai          , Wo          , Ai          , Gd^Fmw      , Aa^Fpa      , Gs^Fdw      , Gd^Fmw      , Aa^Fpa      , Gd^Fmw      , Gs^Fdw      , Gd^Fmw      , Aa^Fpa      
Ms          , Ms          , Ms          , Ms^Xm       , Ms^Xm       , Ms          , Ms          , Ha          , Aa^Fda      , Gd^Fmw      , Gd^Fmw      , Gd          , Gd          , Aa          , Aa          , Aa^Vea      , Aa^Fpa      , Gd^Fmw      , Ha          , Aa^Fpa      , Aa^Fpa      , Gd^Fmw      , Aa^Fpa      , Aa^Fma      , Gd^Fmw      , Gd          , Gd          , Aa^Fma      , Aa^Fma      , Aa^Fma      , Aa^Fda      , Gd^Fmw      , Gd^Fmw      , Gs^Fdw      , Ai          , Wo          , Ai          , Aa^Fpa      , Gd^Fmw      , Gd^Fmw      , Aa          , Aa^Vea      , Gd^Fmw      , Gs^Fdw      , Aa^Fpa      , Gs^Fdw      
Ms          , Ms^Xm       , Ms^Xm       , Ms          , Ms          , Ms          , Ms^Xm       , Ms          , Ha          , Aa^Fpa      , Aa^Fpa      , Gd^Fmw      , Aa^Fpa      , Aa^Fma      , Gd^Fmw      , Gd^Fmw      , Ha          , Ha          , Ms          , Ha          , Ha          , Gd^Fmw      , Gd^Fmw      , Gd^Fmw      , Gd^Fmw      , Aa^Fpa      , Aa          , Gd^Fmw      , Gd^Fmw      , Gd^Fmw      , Aa^Fpa      , Gd^Fmw      , Gd^Fmw      , Gd^Fmw      , Ai          , Ai          , Ai          , Gs^Fdw      , Gd^Fmw      , Gd^Fmw      , Aa          , Aa          , Aa          , Gd^Fmw      , Aa^Fma      , Gd^Fmw      
Ms          , Ms          , Ms          , Ms^Xm       , Ms^Xm       , Ms          , Ms          , Ms^Xm       , Ms^Xm       , Ha          , Ha          , Ha          , Ha          , Gd^Fmw      , Ha          , Ha          , Ms          , Ms^Xm       , Ms^Xm       , Ms          , Ms          , Aa^Fda      , Gs^Fdw      , Aa^Fpa      , Aa          , Gd^Fmw      , Aa          , Aa          , Aa          , Gd^Fmw      , Gd^Fmw      , Gd^Fmw      , Aa^Fma      , Gs^Fdw      , Ai          , Wo          , Ai          , Gd^Fmw      , Aa^Fma      , Gd^Fmw      , Chr         , Chr         , Chr         , Gd^Fmw      , Gd^Fmw      , Gd^Fmw      
Ms          , Ms          , Ms^Xm       , Ms^Xm       , Ms          , Ms          , Ms          , Ms^Xm       , Ms^Xm       , Ms          , Ms^Xm       , Ms          , Ms          , Ha          , Ms          , Ms          , Ms          , Ms          , Ms          , Ms^Xm       , Ms          , Ms          , Gd^Fmw      , Aa^Fda      , Aa          , Aa          , Aa          , Aa^Vea      , Aa          , Aa^Fpa      , Aa^Fda      , Gd^Fmw      , Aa^Fma      , Aa^Fpa      , Ai          , Wo          , Ai          , Gd^Fmw      , Gd^Fmw      , Aa^Fpa      , Chr         , 4 Khr       , Chr         , Aa^Fma      , Gd^Fmw      , Aa^Fma      
Ms          , Ms          , Ms          , Ms          , Ms          , Ms^Xm       , Ms^Xm       , Ms          , Ms          , Ms^Xm       , Ms          , Ms^Xm       , Ms^Xm       , Ms          , Ms          , Ms          , Ms          , Ms          , Ms          , Ms          , Ms          , Ms          , Ha          , Aa^Fma      , Aa^Fma      , Gd          , Gd          , Aa          , Aa          , Gd^Fmw      , Aa^Fda      , Gd^Fmw      , Aa^Fpa      , Gd^Fmw      , Ai          , Wo          , Ai          , Aa^Fpa      , Gd^Fmw      , Aa^Fda      , Aa^Fpa      , Chr         , Gd^Fmw      , Aa^Fma      , Gd^Fmw      , Gd^Fmw      
Ms          , Ms          , Ms^Xm       , Ms^Xm       , Ms^Xm       , Ms          , Ms          , Ms^Xm       , Ms          , Ms          , Ms^Xm       , Ms          , Ms          , Ms^Xm       , Ms^Xm       , Ms          , Ms          , Ms          , Ms          , Ms          , Ms          , Ms          , Ha          , Gd^Fmw      , Gd^Fmw      , Aa^Fma      , Gd          , Gd          , Gd          , Aa^Fma      , Gd^Fmw      , Gd^Fmw      , Gd^Fmw      , Ai          , Wo          , Ai          , Ai          , Gd^Fmw      , Gd^Fmw      , Aa          , Aa^Vea      , Aa          , Aa          , Aa          , Gd^Fmw      , Gd^Fmw      
Ms          , Ms^Xm       , Ms^Xm       , Ms^Xm       , Ms          , Ms          , Ms          , Ms          , Ms^Xm       , Ms^Xm       , Ms          , Ms          , Ms          , Ms          , Ms          , Ms^Xm       , Ms          , Ms          , Ms          , Ms          , Ms          , Ms          , Ha          , Gd^Fmw      , Gd          , Gd          , Gd          , Gd          , Gd          , Aa^Fda      , Aa^Fpa      , Gd^Fmw      , Ai          , Ai          , Wo          , Ai          , Gd^Fmw      , Aa^Fpa      , Gd^Fmw      , Aa          , Aa          , Aa          , Gd^Fmw      , Gs^Fdw      , Aa^Fpa      , Gs^Fdw      
Ms          , Ms          , Ms          , Ms          , Ms          , Ms          , Ms          , Ms          , Ms          , Ms          , Ms          , Ms          , Ms          , Ms          , Ms          , Ms          , Ms          , Ms          , Ms          , Ms          , Ms          , Ms          , Ha          , Gd^Fmw      , Gd^Fmw      , Gd          , Gd          , Gd          , Gd^Fmw      , Gd^Fmw      , Aa^Fpa      , Ai          , Ai          , Wo          , Ai          , Ai          , Aa^Fma      , Aa^Fma      , Aa^Fpa      , Gd^Fmw      , Gd^Fmw      , Aa^Fma      , Aa^Fma      , Aa^Fma      , Gd^Fmw      , Gd^Fmw      
