border_size=1
usage=map

Ms          , Ms^Xm       , Ms          , Ms^Xm       , Ms          , Ms^Xm       , Ms^Xm       , Ms          , Ms          , Ms          , Ms          , Ms          , Ha          , Ha          , Aa          , Gg          , Aa^Fpa      , Gll^Fp      , Aa^Fpa      , Gll^Fp      , Gll^Fp      , Aa          , Aa          , Gg          , Aa^Fpa      , Gll^Fp      , Gll^Fp      , Aa^Fpa      , Aa^Fpa      , Gll^Fp      , Aa^Fpa      , Gll^Fp      , Aa^Fpa      , Gll^Fp      , Gll^Fp      , Aa          , Gg          , Aa          , Aa          , Gg          , Aa^Fpa      , Aa^Fpa      , Gll^Fp      , Aa^Fpa      , Gll^Fp      , Gg          , Aa          , Gg          , Aa^Fpa      , Gll^Fp      , Aa^Fpa      , Aa^Fpa      , Aa^Fpa      , Aa^Fpa      , Gll^Fp      , Aa          , Aa          
Xu          , Ms          , Ms          , Ms          , Ms^Xm       , Ms          , Ms          , Ms          , Ms          , Ms^Xm       , Ms^Xm       , Ms          , Ms          , Ha          , Aa          , Gg          , Aa^Fpa      , Gll^Fp      , Gll^Fp      , Aa^Fpa      , Gll^Fp      , Aa^Fpa      , Gll^Fp      , Aa          , Gg          , Aa^Fpa      , Gll^Fp      , Aa^Fpa      , Aa^Fpa      , Gll^Fp      , Aa^Fpa      , Gll^Fp      , Gll^Fp      , Aa^Fpa      , Gll^Fp      , Aa          , Aa          , Gg          , Gg          , Gg          , Gll^Fp      , Aa^Fpa      , Gll^Fp      , Aa^Fpa      , Aa^Fpa      , Gll^Fp      , Aa^Fpa      , Aa          , Aa^Fpa      , Gll^Fp      , Aa^Vea      , Gll^Fp      , Gll^Fp      , Gll^Fp      , Aa^Fpa      , Aa^Fpa      , Aa          
Xu          , Xu          , Xu          , Ms          , Ms          , Ms          , Ms          , Ms          , Ms          , Ms          , Ms          , Ms^Xm       , Ms^Xm       , Ha          , Ha          , Aa          , Gg          , Aa^Fpa      , Gll^Fp      , Aa^Vea      , Gll^Fp      , Aa^Fpa      , Aa^Fpa      , Gg          , Aa          , Aa^Fpa      , Gll^Fp      , Gll^Fp      , Gll^Fp      , Gg^Ve       , Gll^Fp      , Gll^Fp      , Aa^Fpa      , Gll^Fp      , Gg^Ve       , Aa^Fpa      , Aa^Fpa      , Gg          , Gg          , Aa          , Gll^Fp      , Aa^Vea      , Gll^Fp      , Gll^Fp      , Gll^Fp      , Gll^Fp      , Aa^Fpa      , Aa          , Gg          , Aa^Fpa      , Gll^Fp      , Aa^Fpa      , Gll^Fp      , Aa^Fpa      , Aa^Fpa      , Gll^Fp      , Gg          
Xu          , Xu          , Xu          , Xu          , Xu          , Xu          , Xu          , Ms          , Ms          , Ms          , Ms          , Ms          , Ms          , Ms^Xm       , Ms          , Aa          , Aa          , Gll^Fp      , Aa^Fpa      , Gll^Fp      , Gll^Fp      , Gll^Fp      , Gll^Fp      , Gll^Fp      , Aa          , Gg          , Gg          , Aa^Fpa      , Gll^Fp      , Aa^Fpa      , Gll^Fp      , Aa^Fpa      , Aa^Fpa      , Aa^Fpa      , Gll^Fp      , Gll^Fp      , Ce          , Ce          , Ce          , Aa          , Aa          , Aa^Fpa      , Aa^Fpa      , Aa^Fpa      , Gll^Fp      , Aa^Fpa      , Gll^Fp      , Gll^Fp      , Gg          , Gg          , Cea         , Aa^Fpa      , Aa^Fpa      , Aa^Vea      , Gg          , Gg          , Gg          
Xu          , Xu          , Xu          , Xu          , Xu          , Xu          , Xu          , Xu          , Xu          , Xu          , Xu          , Ms          , Ms          , Ms          , Ms^Xm       , Ha          , Ha          , Aa          , Gg          , Aa^Fpa      , Gll^Fp      , Aa^Fpa      , Aa^Fpa      , Gll^Fp      , Gg          , Aa          , Gg          , Aa^Fpa      , Aa^Fpa      , Gll^Fp      , Aa^Fpa      , Gll^Fp      , Gll^Fp      , Gll^Fp      , Aa^Fpa      , Gll^Fp      , Ce          , 6 Kea       , Ce          , Gg          , Gg          , Gg          , Aa          , Gll^Fp      , Aa^Fpa      , Gll^Fp      , Gll^Fp      , Aa^Vea      , Gll^Fp      , Cea         , 3 Kea       , Cea         , Aa          , Aa          , Aa^Fpa      , Aa          , Aa          
Xu          , Xu          , Cud         , Cud         , Cud         , Xu          , Uh          , Xu          , Xu          , Xu          , Xu          , Xu          , Xu          , Ms          , Ms          , Ms          , Ha          , Aa          , Gg          , Aa^Fpa      , Gll^Fp      , Aa^Vea      , Gll^Fp      , Gll^Fp      , Gg          , Gg          , Gg          , Gg          , Gg          , Gll^Fp      , Aa^Fpa      , Gll^Fp      , Gg^Ve       , Aa^Fpa      , Aa          , Aa          , Aa          , Ce          , Aa^Fpa      , Gll^Fp      , Aa^Fpa      , Gg          , Aa          , Aa^Fpa      , Aa^Vea      , Aa^Fpa      , Gll^Fp      , Aa^Fpa      , Aa^Fpa      , Cea         , Cea         , Cea         , Aa          , Aa^Vea      , Gll^Fp      , Gll^Fp      , Gll^Fp      
Cud         , Cud         , Ur          , Uu          , Uu          , Uh          , Ur          , Uh          , Ur          , Cud         , Cud         , Xu          , Xu          , Xu          , Xu          , Ms          , Ha          , Gg          , Aa          , Aa          , Aa          , Gll^Fp      , Aa^Fpa      , Aa^Fpa      , Gg          , Gg          , Aa^Fpa      , Aa          , Aa          , Gg          , Aa          , Aa^Fpa      , Gll^Fp      , Aa^Fpa      , Gll^Fp      , Gll^Fp      , Aa^Fpa      , Gll^Fp      , Gll^Fp      , Aa^Fpa      , Gll^Fp      , Gg          , Gg          , Aa          , Aa^Fpa      , Gll^Fp      , Aa^Fpa      , Gll^Fp      , Aa          , Gg          , Aa          , Gg          , Gll^Fp      , Aa^Fpa      , Aa^Fpa      , Aa^Fpa      , Gll^Fp      
Ur          , Uu^Vud      , Ur          , Uu^Vud      , Cud         , Uu          , Uu          , Ur          , Uu          , Uu          , Ur          , Cud         , Uh          , Xu          , Cud         , Ha          , Cud         , Rp          , Cud         , Cud         , Rp          , Gg          , Aa          , Gg          , Gg          , Aa^Fpa      , Gll^Fp      , Gll^Fp      , Aa          , Gg          , Aa          , Gll^Fp      , Aa^Fpa      , Gll^Fp      , Aa^Fpa      , Gll^Fp      , Gll^Fp      , Aa^Fpa      , Gll^Fp      , Aa^Fpa      , Gll^Fp      , Gll^Fp      , Aa          , Gg          , Aa          , Aa^Fpa      , Aa          , Aa          , Gg          , Gg          , Gg          , Gll^Fp      , Aa^Fpa      , Gll^Fp      , Aa^Vea      , Aa^Fpa      , Aa^Fpa      
Uu          , Ur          , Uh          , Cud         , 2 Kud       , Cud         , Uh          , Uu^Vud      , Uu          , Uu^Vud      , Ur          , Uu          , Uu          , Uh          , Ur          , Cud         , Ha          , Ha          , Rp          , Rp          , Rp          , Cud         , Cud         , Aa          , Gll^Fp      , Aa^Fpa      , Aa^Vea      , Aa^Fpa      , Gll^Fp      , Gg          , Gll^Fp      , Gll^Fp      , Gll^Fp      , Aa^Fpa      , Aa          , Gg^Ve       , Aa          , Aa^Fpa      , Gll^Fp      , Gll^Fp      , Gll^Fp      , Aa^Vea      , Aa          , Gg          , Aa          , Aa          , Gg          , Aa^Vea      , Aa          , Aa          , Gll^Fp      , Aa^Fpa      , Gll^Fp      , Gll^Fp      , Aa^Fpa      , Aa^Fpa      , Gll^Fp      
Uu          , Uh          , Uh          , Cud         , Cud         , Cud         , Uh          , Uu          , Ur          , Ur          , Uu          , Cud         , Cud         , Ur          , Uu^Vud      , Uu          , Cud         , Ha          , Uu^Vud      , Rp          , Uu^Vud      , Rp          , Rp          , Aa          , Gll^Fp      , Gll^Fp      , Gll^Fp      , Aa^Fpa      , Aa^Fpa      , Aa^Fpa      , Aa^Vea      , Aa^Fpa      , Gg          , Aa          , Gll^Fp      , Aa^Fpa      , Gll^Fp      , Aa          , Gg          , Aa^Fpa      , Aa^Fpa      , Aa^Fpa      , Gg          , Gg          , Gll^Fp      , Aa^Fpa      , Aa^Fpa      , Gg          , Aa          , Aa^Fpa      , Gll^Fp      , Aa^Vea      , Gll^Fp      , Aa^Fpa      , Gll^Fp      , Aa^Fpa      , Aa^Fpa      
Uu          , Ur          , Ur          , Uu^Vud      , Ur          , Ur          , Ur          , Uu          , Uu          , Uu          , Cud         , Uu          , Uu          , Ur          , Uu          , Uu          , Cud         , Rp          , Rp          , Rp          , Rp          , Rp          , Rp          , Rp          , Aa          , Aa^Fpa      , Aa^Fpa      , Gll^Fp      , Aa^Fpa      , Gll^Fp      , Aa^Fpa      , Aa^Fpa      , Gg          , Aa          , Aa^Fpa      , Aa^Fpa      , Gll^Fp      , Aa          , Gg          , Gg          , Gg          , Gg          , Aa          , Gll^Fp      , Aa^Fpa      , Gll^Fp      , Aa^Fpa      , Aa^Fpa      , Gg          , Aa^Fpa      , Aa^Fpa      , Gll^Fp      , Aa^Fpa      , Aa^Fpa      , Aa^Vea      , Aa^Fpa      , Gll^Fp      
Uh          , Uu^Vud      , Ur          , Uu          , Uh          , Uh          , Uu          , Uu^Vud      , Uh          , Cud         , 1 Kud       , Cud         , Ur          , Cud         , Uu          , Ur          , Cud         , Ha          , Rp          , Cud         , Cud         , Uu^Vud      , Rp          , Cud         , Cud         , Aa          , Aa^Fpa      , Gll^Fp      , Gll^Fp      , Gll^Fp      , Gll^Fp      , Gll^Fp      , Gg          , Gg          , Gll^Fp      , Gll^Fp      , Aa^Fpa      , Gll^Fp      , Aa          , Aa          , Gg          , Gg          , Aa          , Aa^Fpa      , Aa^Fpa      , Gll^Fp      , Gg^Ve       , Aa^Fpa      , Aa          , Gg          , Gg          , Gll^Fp      , Aa^Fpa      , Gll^Fp      , Aa^Fpa      , Gll^Fp      , Gll^Fp      
Uh          , Uh          , Uu          , Uu          , Uu^Vud      , Uh          , Uu          , Ur          , Uh          , Cud         , Cud         , Cud         , Ur          , Cud         , Ur          , Uu          , Cud         , Ha          , Rp          , 8 Kud       , Cud         , Rp          , Rp          , Rp          , Rp          , Aa          , Gll^Fp      , Gll^Fp      , Aa^Vea      , Aa^Fpa      , Gll^Fp      , Gg          , Gg          , Gg          , Aa^Fpa      , Gll^Fp      , Aa^Fpa      , Gll^Fp      , Gg          , Aa^Vea      , Gg          , Aa          , Gll^Fp      , Aa^Fpa      , Gll^Fp      , Gll^Fp      , Gll^Fp      , Gll^Fp      , Gg          , Gg          , Aa          , Gg          , Gg          , Aa^Fpa      , Gg          , Aa^Fpa      , Gg          
Ur          , Ur          , Cud         , Ur          , Ur          , Ur          , Uu          , Ur          , Ur          , Uh          , Uu          , Ur          , Cud         , Uu          , Uu^Vud      , Ur          , Ha          , Ha          , Rp          , Cud         , Rp          , Rp          , Uu^Vud      , Rp          , Rp          , Gg          , Gll^Fp      , Aa^Fpa      , Gll^Fp      , Aa^Fpa      , Aa          , Aa          , Aa^Fpa      , Aa^Fpa      , Gll^Fp      , Gll^Fp      , Gll^Fp      , Aa^Fpa      , Gg          , Gg          , Aa^Fpa      , Aa^Fpa      , Aa^Fpa      , Gll^Fp      , Aa^Fpa      , Aa^Fpa      , Gll^Fp      , Aa^Fpa      , Gg          , Aa          , Aa^Fpa      , Aa          , Ce          , Ce          , Ce          , Gg          , Gg          
Cud         , Cud         , Xu          , Xu          , Xu          , Uh          , Uh          , Uu          , Uu          , Uu^Vud      , Uu          , Cud         , Ur          , Ur          , Uu          , Ur          , Cud         , Ha          , Rp          , Rp          , Rp          , Rp          , Rp          , Rp          , Cud         , Gg          , Aa^Fpa      , Gll^Fp      , Aa^Fpa      , Gll^Fp      , Aa          , Gll^Fp      , Gll^Fp      , Gll^Fp      , Gll^Fp      , Aa^Vea      , Aa^Fpa      , Gll^Fp      , Aa          , Gg          , Aa^Fpa      , Gll^Fp      , Gll^Fp      , Gg^Ve       , Gll^Fp      , Aa^Fpa      , Gg^Ve       , Aa          , Gg          , Aa^Fpa      , Aa^Vea      , Gll^Fp      , Ce          , 5 Kea       , Ce          , Gg          , Gg          
Xu          , Xu          , Xu          , Xu          , Xu          , Cud         , Cud         , Uh          , Ur          , Uu          , Ur          , Uu          , Ur          , Uu          , Cud         , Cud         , Ha          , Ha          , Rp          , Uu^Vud      , Rp          , Rp          , Rp          , Cud         , Aa          , Gg          , Gg          , Aa^Fpa      , Aa          , Gg          , Gll^Fp      , Aa^Fpa      , Aa^Fpa      , Aa^Fpa      , Gll^Fp      , Gll^Fp      , Aa^Fpa      , Gll^Fp      , Aa          , Gg          , Gg          , Gll^Fp      , Aa^Fpa      , Aa^Fpa      , Aa^Fpa      , Gll^Fp      , Aa          , Aa          , Gg          , Aa^Fpa      , Gll^Fp      , Aa^Fpa      , Gll^Fp      , Ce          , Aa^Fpa      , Aa^Fpa      , Gll^Fp      
Xu          , Xu          , Ur          , Ur          , Ur          , Uu^Vud      , Uu^Vud      , Cud         , Uh          , Ur          , Cud         , Cud         , Xu          , Xu          , Xu          , Cud         , Cud         , Rp          , Rp          , Rp          , Cud         , Cud         , Gg          , Gg          , Aa          , Aa          , Gll^Fp      , Aa          , Gg          , Gg          , Aa^Fpa      , Gll^Fp      , Aa^Vea      , Gll^Fp      , Aa^Fpa      , Gll^Fp      , Gg          , Aa          , Gg          , Gg          , Aa          , Gg          , Aa          , Aa          , Aa          , Gg          , Gg          , Gg          , Gll^Fp      , Gg          , Aa          , Aa^Vea      , Aa^Fpa      , Aa^Fpa      , Aa^Vea      , Gll^Fp      , Aa^Fpa      
Xu          , Xu          , Ur          , Cud         , 7 Kud       , Cud         , Ur          , Cud         , Uh          , Uh          , Xu          , Xu          , Xu          , Xu          , Ms^Xm       , Ha          , Ha          , Cud         , Aa          , Cud         , Gg          , Gg          , Aa^Fpa      , Gll^Fp      , Aa^Fpa      , Gll^Fp      , Aa^Fpa      , Gll^Fp      , Gg          , Aa          , Aa^Fpa      , Gll^Fp      , Gll^Fp      , Aa^Fpa      , Gll^Fp      , Gll^Fp      , Gg          , Gg          , Gg          , Aa          , Aa^Fpa      , Gg          , Gg          , Gg          , Gg          , Gg          , Aa^Fpa      , Aa^Fpa      , Gll^Fp      , Aa^Fpa      , Aa^Fpa      , Aa          , Gg          , Gll^Fp      , Gll^Fp      , Gll^Fp      , Aa^Fpa      
Xu          , Xu          , Uu^Vud      , Cud         , Ur          , Cud         , Ur          , Cud         , Xu          , Xu          , Xu          , Xu          , Xu          , Xu          , Ms^Xm       , Ms^Xm       , Ms          , Ha          , Aa          , Aa          , Gll^Fp      , Aa^Fpa      , Gll^Fp      , Gll^Fp      , Gll^Fp      , Aa^Fpa      , Gll^Fp      , Gll^Fp      , Gg          , Aa          , Aa          , Aa^Fpa      , Gg          , Aa^Fpa      , Gg          , Gg          , Aa          , Aa          , Gll^Fp      , Aa^Fpa      , Gll^Fp      , Aa^Fpa      , Gll^Fp      , Aa^Vea      , Gg          , Gg          , Gll^Fp      , Gll^Fp      , Gll^Fp      , Aa^Fpa      , Aa^Fpa      , Aa          , Gg          , Gg          , Aa          , Aa^Fpa      , Aa          
Xu          , Xu          , Xu          , Uu^Vud      , Cud         , Ur          , Cud         , Cud         , Xu          , Xu          , Ms^Xm       , Ms^Xm       , Ms          , Ms^Xm       , Ms          , Ms          , Ha          , Ha          , Aa          , Aa          , Gll^Fp      , Aa^Fpa      , Gll^Fp      , Aa^Fpa      , Aa^Fpa      , Aa^Vea      , Aa^Fpa      , Aa^Fpa      , Gg          , Gg          , Gg          , Gg          , Aa^Fpa      , Gg          , Aa          , Gg          , Aa          , Aa^Fpa      , Gll^Fp      , Gll^Fp      , Aa^Vea      , Gll^Fp      , Aa^Fpa      , Gg          , Ce          , Aa          , Aa^Fpa      , Aa^Fpa      , Gll^Fp      , Gll^Fp      , Gll^Fp      , Gll^Fp      , Aa^Fpa      , Gg          , Aa          , Aa          , Gg          
Xu          , Xu          , Xu          , Xu          , Xu          , Xu          , Xu          , Xu          , Xu          , Xu          , Ms^Xm       , Ms^Xm       , Ms          , Ms          , Ms          , Ms          , Ha          , Aa          , Gg          , Gll^Fp      , Aa^Fpa      , Aa^Vea      , Gll^Fp      , Aa^Fpa      , Gll^Fp      , Gll^Fp      , Gg          , Aa          , Aa          , Aa          , Gll^Fp      , Gll^Fp      , Gll^Fp      , Aa^Fpa      , Aa          , Gg          , Gg          , Aa^Fpa      , Aa^Fpa      , Aa^Fpa      , Gll^Fp      , Aa^Fpa      , Gll^Fp      , Ce          , 4 Kea       , Ce          , Aa^Fpa      , Gll^Fp      , Aa^Fpa      , Aa^Fpa      , Gll^Fp      , Aa^Fpa      , Gll^Fp      , Gg          , Gg          , Gg          , Aa          
Xu          , Xu          , Xu          , Xu          , Xu          , Xu          , Xu          , Xu          , Ms^Xm       , Ms          , Ms          , Ms^Xm       , Ms^Xm       , Ms          , Ms          , Ms          , Ha          , Aa          , Gg          , Aa^Fpa      , Gll^Fp      , Aa^Fpa      , Gll^Fp      , Aa^Fpa      , Aa          , Gg          , Gg          , Aa          , Gll^Fp      , Aa^Fpa      , Aa^Fpa      , Aa^Fpa      , Gll^Fp      , Aa^Fpa      , Gll^Fp      , Aa          , Gg          , Gg          , Gll^Fp      , Aa^Fpa      , Aa^Fpa      , Gll^Fp      , Aa^Fpa      , Ce          , Ce          , Ce          , Gll^Fp      , Aa^Vea      , Gll^Fp      , Aa^Fpa      , Aa^Vea      , Aa^Fpa      , Aa^Fpa      , Aa          , Gg          , Aa          , Aa          
Xu          , Xu          , Xu          , Xu          , Xu          , Xu          , Ms^Xm       , Ms          , Ms          , Ms          , Ms^Xm       , Ms          , Ms          , Ms^Xm       , Ms          , Ha          , Aa          , Aa          , Gg          , Aa          , Aa          , Gll^Fp      , Gg          , Aa          , Gg          , Gg          , Aa^Fpa      , Aa^Fpa      , Aa^Fpa      , Aa^Vea      , Gll^Fp      , Aa^Fpa      , Aa^Fpa      , Aa^Vea      , Aa^Fpa      , Aa^Fpa      , Gg          , Aa          , Aa^Fpa      , Aa^Vea      , Gll^Fp      , Aa^Fpa      , Gll^Fp      , Gll^Fp      , Gg          , Aa          , Aa^Fpa      , Aa^Fpa      , Gll^Fp      , Aa^Fpa      , Aa^Fpa      , Gll^Fp      , Gll^Fp      , Aa^Fpa      , Aa          , Gg          , Gg          
Xu          , Xu          , Xu          , Xu          , Ms^Xm       , Ms^Xm       , Ms          , Ms          , Ms          , Ms          , Ms          , Ms          , Ms          , Ms          , Ha          , Ha          , Aa          , Gg          , Gg          , Gg          , Aa          , Gg          , Gg          , Aa          , Gg          , Aa^Fpa      , Gll^Fp      , Gll^Fp      , Gll^Fp      , Gll^Fp      , Aa^Fpa      , Aa^Fpa      , Gll^Fp      , Gll^Fp      , Gll^Fp      , Aa^Fpa      , Gg          , Aa          , Aa          , Aa^Fpa      , Gll^Fp      , Gll^Fp      , Aa^Fpa      , Aa^Fpa      , Gg          , Aa          , Aa          , Aa^Fpa      , Aa^Fpa      , Gll^Fp      , Gll^Fp      , Gll^Fp      , Aa^Fpa      , Aa^Fpa      , Aa          , Aa          , Aa          
