border_size=1
usage=map

Mm          , Mm          , Mm          , Hh          , Ds          , Gs^Ft       , Gs^Ft       , Gs^Ft       , Gs^Ft       , Gs          , Ds          , Ww          , Ww          , Wo          , Wo          , Wo          , Wo          , Wo          , Wo          , Wo          , Wo          , Wo          , Wo          , Wo          , Wo          , Wo          , Wo          , Wo          , Wo          
Mm          , Mm          , Mm^Xm       , Hh          , Hh          , Ds          , Gg          , Gg          , Ds          , Gs          , Gs          , Ww          , Ww          , Ww          , Ww          , Wo          , Wo          , Wo          , Wo          , Wo          , Wo          , Wo          , Wo          , Wo          , Wo          , Wo          , Wo          , Wo          , Wo          
Mm          , Mm          , Mm          , Mm          , Hh          , Ds          , Gg          , Ce          , 1 Ke        , Gg          , Gs          , Ds          , Ds          , Ww          , Ww          , Wo          , Wo          , Wo          , Wo          , Wo          , Wo          , Wo          , Wo          , Wo          , Wo          , Wo          , Wo          , Wo          , Wo          
Mm          , Mm          , Mm          , Mm          , Mm          , Hh          , Ds          , Ce          , Ds          , Ce          , Gg          , Gg          , Gg          , Ds          , Ww          , Ww          , Wo          , Wo          , Wo          , Wo          , Wo          , Wo          , Wo          , Wo          , Wo          , Wo          , Wot         , Wo          , Wo          
Mm          , Mm^Xm       , Mm^Xm       , Mm          , Mm          , Hh          , Hh          , Gg          , Gg          , Gg          , Ds          , Ds          , Gs^Ft       , Ds          , Ww          , Ww          , Wo          , Wo          , Wo          , Wo          , Wo          , Wo          , Wo          , Wo          , Wot         , Wot         , Wot         , Wot         , Wot         
Mm          , Mm          , Mm          , Mm^Xm       , Mm          , Mm          , Hh          , Gs^Ft       , Ds          , Gg          , Gs          , Ds          , Gs^Ft       , Ds          , Ww          , Ww          , Wo          , Wo          , Wo          , Wo          , Wo          , Wo          , Wo          , Wo          , Wot         , Wot         , Wot         , Wot         , Wot         
Mm          , Mm          , Mm          , Mm          , Mm          , Mm^Xm       , Mm          , Hh          , Ss          , Ds          , Gs          , Ds          , Ds          , Gs^Ft       , Ds          , Ww          , Wo          , Wo          , Wo          , Wo          , Wo          , Wo          , Wo          , Wo          , Wot         , Wot         , Wot         , Wot         , Wot         
Mm          , Mm          , Mm^Xm       , Mm          , Mm          , Mm          , Mm          , Hh          , Ss          , Ds          , Gs^Ft       , Gs          , Gg          , Gg          , Ds          , Ww          , Wo          , Wo          , Wot         , Wot         , Wot         , Wot         , Wot         , Wot         , Wot         , Wot         , Wot         , Wot         , Wot         
Mm          , Mm          , Mm          , Mm^Xm       , Mm^Xm       , Mm          , Mm          , Hh          , Ds          , Ss          , Ds          , Gs^Ft       , Gg          , Gg          , Ds          , Ww          , Wo          , Wo          , Wot         , Wot         , Wot         , Wot         , Wot         , Wot         , Wot         , Wot         , Wot         , Wot         , Wot         
Mm          , Mm^Xm       , Mm^Xm       , Mm          , Mm          , Mm          , Mm^Xm       , Mm          , Gs^Ft       , Ds          , Gs          , Ds          , Gg          , Ds          , Gs^Ft       , Ww          , Wwt         , Wot         , Wot         , Wot         , Wot         , Wot         , Wot         , Wot         , Wot         , Wot         , Wot         , Wot         , Wot         
Mm          , Mm          , Mm          , Mm^Xm       , Mm          , Mm          , Mm          , Mm          , Gs          , Gs          , Gg          , Ds          , Gg          , Ds          , Gs^Ft       , Ds          , Wot         , Wot         , Wot         , Wot         , Wot         , Wot         , Wot         , Wot         , Wot         , Wot         , Wot         , Wot         , Wot         
Mm          , Mm^Xm       , Mm^Xm       , Mm          , Mm          , Mm^Xm       , Mm          , Mm          , Gs          , Ds          , Ds          , Gg          , Ds          , Ds          , Gs          , Ds          , Wot         , Wot         , Wot         , Wot         , Wot         , Wot         , Wot         , Wot         , Wot         , Wot         , Wot         , Wot         , Wot         
Mm          , Mm          , Mm          , Mm^Xm       , Mm          , Mm          , Mm          , Mm          , Ss          , Ss          , Ds          , Gs          , Gs          , Gs          , Ds          , Wot         , Wot         , Wot         , Wot         , Wot         , Wot         , Wot         , Wot         , Wot         , Wot         , Wot         , Wot         , Wot         , Wot         
Mm          , Mm          , Mm          , Mm          , Mm          , Mm          , Mm          , Hh          , Ss          , Ds          , Gs^Ft       , Gg          , Ds          , Gg          , Ds          , Wot         , Wot         , Wot         , Wot         , Wot         , Wot         , Wot         , Wot         , Wot         , Wot         , Wot         , Wot         , Wot         , Wot         
Mm          , Mm          , Mm^Xm       , Mm          , Mm          , Mm          , Mm          , Hh          , Ds          , Gs^Ft       , Gs^Ft       , Ds          , Gg          , Gg          , Gs^Ft       , Wot         , Wot         , Wot         , Wot         , Wot         , Wot         , Wot         , Wot         , Wot         , Wot         , Wot         , Wot         , Wot         , Wot         
Mm          , Mm          , Mm          , Mm^Xm       , Mm^Xm       , Mm          , Mm          , Mm          , Ss          , Ds          , Gs          , Ds          , Gg          , Ds          , Gs^Ft       , Ds          , Ds          , Wot         , Wot         , Wot         , Wot         , Wot         , Wot         , Wot         , Wot         , Wot         , Wot         , Wot         , Wot         
Mm          , Mm          , Mm          , Mm          , Mm          , Mm          , Mm          , Mm          , Hh          , Ds          , Gg          , Ds          , Gg          , Ds          , Ds          , Gs          , Ds          , Wot         , Wot         , Wot         , Wot         , Wot         , Wot         , Wot         , Wot         , Wot         , Wot         , Wot         , Wot         
Mm          , Mm^Xm       , Mm^Xm       , Mm          , Mm          , Mm^Xm       , Mm          , Hh          , Hh          , Ds          , Gg          , Gg          , Ds          , Gs          , Gs          , Gs          , Ds          , Wot         , Wot         , Wot         , Wot         , Wot         , Wot         , Wot         , Wot         , Wot         , Wot         , Wot         , Wot         
Mm          , Mm          , Mm          , Mm^Xm       , Mm          , Mm          , Mm          , Mm^Xm       , Mm          , Gs^Ft       , Gg          , Ds          , Gs^Ft       , Ds          , Ds          , Gs^Ft       , Ds          , Wot         , Wot         , Wot         , Wot         , Wot         , Wot         , Wot         , Wot         , Wot         , Wot         , Wot         , Wot         
Mm          , Mm          , Mm          , Mm          , Mm^Xm       , Mm^Xm       , Mm          , Mm          , Mm          , Gs^Ft       , Ds          , Gs          , Gs          , Ds          , Gs^Ft       , Gs^Ft       , Ds          , Wot         , Wot         , Wot         , Wot         , Wot         , Wot         , Wot         , Wot         , Wot         , Wot         , Wot         , Wot         
Mm          , Mm          , Mm          , Mm^Xm       , Mm          , Mm          , Mm          , Mm          , Hh          , Gs          , Ds          , Ds          , Ds          , Gg          , Ds          , Ss          , Ds          , Wot         , Wot         , Wot         , Wot         , Wot         , Wot         , Wot         , Wot         , Wot         , Wot         , Wot         , Wot         
Mm          , Mm          , Mm          , Mm          , Mm          , Mm          , Hh          , Hh          , Gs          , Gs          , Gg          , Ds          , Gg          , Gg          , Ds          , Ds          , Gs          , Wot         , Wot         , Wot         , Wot         , Wot         , Wot         , Wot         , Wot         , Wot         , Wot         , Wot         , Wot         
Mm          , Mm          , Mm          , Mm          , Mm          , Mm          , Mm          , Hh          , Gs^Ft       , Ds          , Ds          , Gg          , Gs          , Ds          , Gg          , Ds          , Gs          , Ds          , Wot         , Wot         , Wot         , Wot         , Wot         , Wot         , Wot         , Wot         , Wot         , Wot         , Wot         
Mm          , Mm^Xm       , Mm^Xm       , Mm          , Mm          , Mm          , Mm          , Gs^Ft       , Ds          , Ds          , Gg          , Ds          , Gs          , Gg          , Gg          , Gs          , Hh          , Ds          , Wot         , Wot         , Wot         , Wot         , Wot         , Wot         , Wot         , Wot         , Wot         , Wot         , Wot         
Mm          , Mm          , Mm          , Mm^Xm       , Mm          , Mm          , Hh          , Ds          , Ds          , Ds          , Gg          , Gs          , Ds          , Ds          , Ds          , Hh          , Mm          , Hh          , Hh          , Wot         , Wot         , Wot         , Wot         , Wot         , Wot         , Wot         , Wot         , Wot         , Wot         
Mm          , Mm          , Mm          , Mm          , Mm          , Hh          , Ds          , Ds          , Ds          , Gs          , Ds          , Ss          , Ss          , Ss          , Gs^Ft       , Mm          , Mm          , Mm          , Hh          , Wot         , Wot         , Wot         , Wot         , Wot         , Wot         , Wot         , Wot         , Wot         , Wot         
Mm          , Mm          , Mm          , Mm          , Hh          , Hh          , Gs^Ft       , Gs^Ft       , Ds          , Chr         , Chr         , Ds          , Gg          , Gs^Ft       , Gs^Ft       , Hh          , Mm          , Hh          , Hh          , Wot         , Wot         , Wot         , Wot         , Wot         , Wot         , Wot         , Wot         , Wot         , Wot         
Mm          , Mm          , Mm          , Mm          , Mm          , Hh          , Gs          , Ds          , Chr         , 2 Khr       , Ds          , Gg          , Ds          , Ds          , Ds          , Hh          , Mm          , Hh          , Wot         , Wot         , Wot         , Wot         , Wot         , Wot         , Wot         , Wot         , Wot         , Wot         , Wot         
Mm          , Mm          , Mm^Xm       , Mm^Xm       , Mm          , Hh          , Ds          , Gs          , Gs          , Chr         , Ds          , Gs          , Hh          , Hh          , Mm          , Mm          , Hh          , Hh          , Wot         , Wot         , Wot         , Wot         , Wot         , Wot         , Wot         , Wot         , Wot         , Wot         , Wot         
Mm          , Mm^Xm       , Mm^Xm       , Mm          , Mm^Xm       , Hh          , Ds          , Ds          , Gs          , Gg          , Gs          , Gs          , Hh          , Mm          , Mm          , Mm          , Hh          , Wot         , Wot         , Wot         , Wot         , Wot         , Wot         , Wot         , Wot         , Wot         , Wot         , Wot         , Wot         
Mm^Xm       , Mm          , Mm^Xm       , Mm^Xm       , Mm^Xm       , Xu          , Xu          , Ss          , Mm^Xm       , Gg          , Xu          , Hh          , Mm^Xm       , Mm          , Hh          , Hh          , Wot         , Wot         , Wot         , Wot         , Wot         , Wot         , Wot         , Wot         , Wot         , Wot         , Wot         , Wot         , Wot         
Mm^Xm       , Mm^Xm       , Mm          , Mm^Xm       , Gs          , Xu          , Gg          , Mm^Xm       , Mm^Xm       , Xu          , Xu          , Mm^Xm       , Mm^Xm       , Mm          , Hh          , Wot         , Wot         , Wot         , Wot         , Wot         , Wot         , Wot         , Wot         , Wot         , Wot         , Wot         , Wot         , Wot         , Wot         
Mm          , Mm          , Mm          , Hh          , Gs          , Ds          , Gg          , Gg          , Gs          , Gs          , Gs          , Gg          , Mm^Xm       , Mm^Xm       , Wot         , Wot         , Wot         , Wot         , Wot         , Wot         , Wot         , Wot         , Wot         , Wot         , Wot         , Wot         , Wot         , Wot         , Wot         
Mm          , Mm          , Hh          , Hh          , Ds          , Ds          , Gs          , Ds          , Ds          , Gs          , Gg          , Ds          , Wot         , Wot         , Wot         , Wot         , Wot         , Wot         , Wot         , Wot         , Wot         , Wot         , Wot         , Wot         , Wot         , Wot         , Wot         , Wot         , Wot         
Mm          , Mm          , Hh          , Gg          , Gg          , Ds          , Gs          , Gs          , Gg          , Ds          , Gg          , Ds          , Wot         , Wot         , Wot         , Wot         , Wot         , Wot         , Wot         , Wot         , Wot         , Wot         , Wot         , Wot         , Wot         , Wot         , Wot         , Wot         , Wot         
