border_size=1
usage=map

Re          , Re^Dr       , Re^Dr       , Re          , Wwf         , Wwf         , Ww          , Re          , Gg          , Gg          , Gs^Dr       , Gg^Eff      , Gg^Eff      , Rb          , Rb          , Rb          , Rb          , Rb          , Rb          , Rb          , Rb          , Rb          , Rb          , Rb          , Gg^Eff      , Gg^Eff      , Gg          , Re          , Re^Dr       , Gg          , Gg          , Gg          , Gs^Fms      , Gs          , Gs          , Gs^Fms      , Gg          , Gg          , Gg          , Gs^Fms      , Gg          , Gs          , Gg          , Gs^Fms      , Gs          , Gg          , Gg          , Gg          
Re          , Gg          , Gg          , Gg          , Ww          , Wo          , Wo          , Ww          , Ww          , Gg          , Gg          , Gs^Dr       , Gg          , Gg^Eff      , Gg^Eff      , Rb          , Rb          , Rb          , Rb          , Rb          , Rb          , Rb          , Gg^Eff      , Gg^Eff      , Gs^Dr       , Gs^Dr       , Gg^Dr       , Re          , Re^Dr       , Re^Dr       , Gg          , Gs          , Gs^Fms      , Gs^Fms      , Gg          , Gg          , Gg          , Gs          , Gs^Fms      , Gg          , Gg          , Gg          , Gs          , Gs          , Gs          , Gs^Fms      , Gg          , Gg          
Gg          , Gg          , Gg^Eff      , Gg          , Gg          , Ww          , Ww          , Wo          , Wo          , Ww          , Gs^Fds      , Gg          , Gs^Dr       , Gs^Dr       , Gs^Dr       , Gg^Eff      , Gg^Eff      , Rb          , Rb          , Rb          , Gg^Eff      , Gg^Eff      , Rb          , Gg^Eff      , Gg^Eff      , Gs^Dr       , Gg          , Gg          , Re          , Re^Dr       , Gg          , Gs          , Gs          , Gg          , Gg          , Gg          , Gs          , Gs^Fms      , Gs^Fms      , Gg          , Gg          , Gs          , Gg          , Gg          , Gs^Fms      , Gs^Fms      , Gg          , Gg          
Gg^Eff      , Gg^Eff      , Re          , Gg^Eff      , Gg^Eff      , Gg          , Gg          , Ww          , Wo          , Ww          , Gs^Fds      , Gg          , Gg          , Gs^Dr       , Rp          , Gg          , Gg          , Gg^Eff      , Gg^Eff      , Gg^Eff      , Gg^Eff      , Rb          , Rb          , Rb          , Rb          , Gg^Eff      , Gg^Eff      , Gg          , Re          , Re          , Gg          , Gg          , Gg          , Gs          , Gs^Fms      , Gs^Fms      , Gs          , Gs          , Gs          , Gg          , Gg          , Gs          , Gs          , Gg          , Gs^Fms      , Gg          , Gg          , Gg          
Gg^Eff      , Re          , Re          , Re          , Re          , Gg^Eff      , Gg^Eff      , Ww          , Ww          , Ww          , Ww          , Gg          , Gd^Xff      , Gd^Xff      , Rp          , Re^Dr       , Rp          , Rp          , Rp          , Re^Dr       , Re^Dr       , Gg^Eff      , Gg^Eff      , Rb          , Rb          , Rb          , Gg^Eff      , Gg^Eff      , Gg          , Re^Dr       , Gg          , Gg          , Gg          , Gs          , Gs          , Gs^Fms      , Gs^Fms      , Gs          , Gs^Fms      , Gs^Fms      , Gg          , Gs          , Gs^Fms      , Gs          , Gs          , Gg          , Gg          , Gg          
Gg          , Gg^Eff      , Gg^Eff      , Re          , Gg^Eff      , Gg^Eff      , Gg          , Ww          , Ww          , Wo          , Wo          , Ww          , Ww          , Gd^Xff      , Ww          , Rp          , Ww          , Ww          , Ww          , Rp          , Rp          , Rp          , Rp          , Gg^Eff      , Gg^Eff      , Gg^Eff      , Gd^Xff      , Gd^Xff      , Gg          , Re^Dr       , Gg          , Gg          , Gg          , Gg          , Gg          , Gg          , Gg          , Gg          , Gg          , Gs^Fms      , Gg          , Gg          , Gs^Fms      , Gs^Fms      , Gg          , Gg          , Gg          , Gg          
Gg          , Gg          , Gg          , Gg^Eff      , Gg          , Gg          , Re^Dr       , Rp          , Ww          , Ww          , Wo          , Ww          , Wo          , Ww          , Wo          , Ww          , Ww          , Wo          , Wo          , Ww          , Ww          , Ww          , Ww          , Rp          , Gg          , Gg          , Gg          , Gd^Xff      , Gg          , Re          , Gg          , Gg          , Gg          , Gg          , Gg          , Gg          , Gg          , Gg          , Gg          , Gg          , Gg          , Gs          , Gs          , Gs          , Gg          , Gg          , Gg          , Gg          
Gs^Dr       , Gs^Dr       , Gg          , Gg          , Gg          , Re^Dr       , Rp          , Rp          , Ww          , Wo          , Wo          , Ww          , Wo          , Ww          , Ww          , Ww          , Chr         , Ww          , Ww          , Ww          , Ww          , Wo          , Ww          , Rp          , Rp          , Re^Dr       , Re^Dr       , Gg          , Re          , Re          , Re          , Gg          , Gg          , Gg          , Gg          , Gg          , Gg          , Gg          , Gg          , Gg          , Gg          , Gg          , Gg          , Gg          , Gg          , Gg          , Gg          , Gg          
Gg          , Gg^Dr       , Gs^Dr       , Gs^Dr       , Rp          , Rp          , Ww          , Ww          , Ww          , Ww          , Ww          , Ww          , Wo          , Wo          , Ww          , Rrc         , Gg          , Gg          , Gg          , Rr^Dr       , Rrc         , Ww          , Ww          , Ww          , Ww          , Rp          , Rp          , Gg          , Re          , Re^Dr       , Gg          , Gg          , Gg          , Gg          , Gg          , Gg          , Gg          , Gg          , Gg^Eff      , Gg^Eff      , Gg^Eff      , Gg          , Gg          , Gg          , Gg          , Gg          , Gg          , Gg          
Gs^Dr       , Gg^Dr       , Gg          , Rp          , Ww          , Ww          , Ww          , Ww          , Rrc         , Chr         , Gg          , Ww          , Ww          , Ww          , Ww          , Rrc         , Rrc         , Rrc^Dr      , Rrc         , Rrc         , Gg          , Rrc         , Chr         , Ww          , Ww          , Ww          , Rp          , Gs^Fms      , Gg          , Re^Dr       , Gg          , Gg          , Gg          , Gg          , Gg          , Gg          , Gg^Eff      , Gg^Eff      , Rb          , Rb          , Rb          , Gg^Eff      , Gg^Eff      , Gg          , Gg          , Gg          , Gg          , Gg          
Gs^Dr       , Gs^Dr       , Gg          , Rp          , Ww          , Wo          , Ww          , Rr^Dr       , Rrc         , Rrc         , Rrc         , Gg^Dr       , Ww          , Wo          , Wo          , Ww          , Ww^Es       , Rrc         , Ww          , Gg^Dr       , Ww          , Rr^Dr       , Chr         , Chr         , Ww          , Ww          , Ww          , Rp          , Re^Dr       , Re          , Gg          , Gg          , Gg          , Gg          , Gg^Eff      , Gg^Eff      , Rb          , Rb          , Rb          , Rb          , Rb          , Rb          , Rb          , Gg^Eff      , Gg^Eff      , Gg          , Gg          , Gg          
Gg          , Gg          , Gg          , Rp          , Ww          , Ww          , Rrc         , Rrc         , Rr^Dr       , Gg^Dr       , Gg          , Rrc         , Ww          , Ww          , Ww          , Wo          , Wo          , Ww          , Wo          , Ww          , Ww          , Ww          , Ww          , Rr^Dr       , Ww          , Wo          , Ww          , Re          , Re^Dr       , Re          , Gg          , Gg          , Gg^Eff      , Gg^Eff      , Rb          , Rb          , Rb          , Rb          , Rb          , Rb          , Rb          , Rb          , Rb          , Rb          , Rb          , Gg^Eff      , Gg^Eff      , Gg          
Gg          , Gg          , Gs^Dr       , Rp          , Ww          , Ww          , Rrc         , Chr         , Chr         , Rr^Dr       , Ww          , Ww^Bsb|     , Ww          , Ww          , Chr         , Ww          , Ww^Es       , Wo          , Ww          , Ww          , Rr^Dr       , Ww          , Ww          , Ww          , Wo          , Ww          , Gg          , Re          , Re          , Gg          , Gg^Eff      , Gg^Eff      , Rb          , Rb          , Rb          , Rb          , Rb          , Rb          , Rb          , Rb          , Rb          , Rb          , Rb          , Rb          , Gg^Eff      , Gg^Eff      , Gg          , Gg          
Gs^Dr       , Gs^Dr       , Gs^Dr       , Rp          , Ww          , Ww          , Ww          , Rr^Dr       , Ww          , Ww          , Ww          , Ww^Bsb|     , Rr^Dr       , Rrc         , Gg          , Rr^Dr       , Rrc         , Ww          , Chr         , Rrc         , Gs^Fds      , Chr         , Rrc         , Ww          , Ww          , Ww          , Gg          , Rp          , Re^Dr       , Re          , Gg          , Gg^Eff      , Gg^Eff      , Rb          , Rb          , Rb          , Rb          , Rb          , Rb          , Rb          , Rb          , Rb          , Gg^Eff      , Gg^Eff      , Gg          , Gg          , Gg          , Gg          
Gg^Eff      , Gs^Dr       , Gg          , Rp          , Rp          , Ww          , Ww          , Ww          , Wo          , Ww          , Chr         , Rrc         , Gg          , Gg          , Gs^Fds      , Gg          , Rrc         , Ch          , Gg          , Gg          , Gg          , Gs^Fdw      , Gg          , Chr         , Ww          , Ww          , Gg          , Rp          , Re          , Re^Dr       , Gg          , Gg          , Gg          , Gg^Eff      , Gg^Eff      , Rb          , Rb          , Rb          , Rb          , Rb          , Gg^Eff      , Gg^Eff      , Gg          , Gg          , Gg          , Gg          , Gg          , Gg          
Rb          , Gg^Eff      , Gg^Eff      , Re^Dr       , Gg          , Rp          , Rp          , Ww          , Ww          , Ww          , Rrc         , Rrc         , Rrc         , Gg^Dr       , Gs^Fdw      , Gg          , Gg          , Rrc         , Rrc         , Gg^Dr       , Gd^Xff      , Gg          , Gg          , Chr         , Ww          , Ww          , Ww          , Rp          , Re          , Re^Dr       , Gg          , Gg          , Gg          , Gg          , Gg          , Gg^Eff      , Gg^Eff      , Rb          , Gg^Eff      , Gg^Eff      , Gg          , Gg          , Gg          , Gg          , Gg          , Gg          , Gg          , Gg          
Rb          , Rb          , Rb          , Gg^Eff      , Gg^Eff      , Gg          , Gg          , Rp          , Ww          , Ww          , Chr         , Rp^Vhcr     , Gg          , Rrc         , Rrc         , Gs^Fdw      , Gg          , Rrc^Xfv     , Rrc         , Gg          , Gd^Xff      , Rrc^Xfv     , Gg          , Rrc         , Chr         , Ww          , Ww          , Rp          , Gg          , Re          , Gg          , Gg          , Gg          , Gg          , Gll^Fp      , Gg          , Gg          , Gg^Eff      , Gg          , Gg          , Gll^Fp      , Gs^Fms      , Gs          , Gg          , Gg          , Gg          , Gg          , Gg          
Rb          , Rb          , Rb          , Rb          , Gg^Eff      , Gg^Eff      , Rp          , Rp          , Ww          , Ww          , Ww          , Chr         , Gg          , Gg          , Gg          , Rrc         , Gg^Dr       , Gg          , Rrc         , Gg          , Gg          , Gd^Xff      , Gg          , Gg          , Chr         , Ww          , Ww          , Rp          , Rp          , Re          , Re          , Gg          , Gll^Fp      , Gs^Fms      , Gs          , Gs          , Gll^Fp      , Gll^Fp      , Gs^Fms      , Gs          , Gs          , Gs          , Gs          , Gll^Fp      , Gs          , Gll^Fp      , Gs^Fms      , Gg          
Rb          , Rb          , Gg^Eff      , Gg^Eff      , Gg          , Re^Dr       , Rp          , Ww          , Wo          , Wo          , Ww          , Rrc         , Gg          , Gg^Dr       , Gd^Xff      , Rrc         , Rrc         , Rrc         , Rr^Dr       , Rrc         , Rrc         , Gg          , Gg          , Gs^Fds      , Rrc         , Ww          , Ww          , Ww          , Rp          , Re^Dr       , Re          , Gg          , Gll^Fp      , Gs          , Gs^Fms      , Gs          , Gs^Fds      , Gs^Fds      , Gs^Fds      , Gs^Fms      , Gs          , Gll^Fp      , Gs          , Gll^Fp      , Gs^Fms      , Gs          , Gs          , Gg          
Gg^Eff      , Gg^Eff      , Gs^Dr       , Gs^Dr       , Gs^Dr       , Gg          , Rp          , Ww^Es       , Ww^Es       , Ww          , Chr         , Rrc         , Gg          , Gd^Xff      , Gg^Dr       , Gg          , Rrc         , Rr^Dr       , 2 Khr       , Chr         , Rrc         , Gg^Dr       , Gs^Fds      , Gs^Fdw      , Rrc         , Chr         , Ww^Bsb/     , Ww^Bsb/     , Rp          , Re^Dr       , Re          , Gg          , Gg          , Gs          , Gll^Fp      , Gs^Fds      , Wwf         , Wwf         , Wwf         , Gs^Fds      , Gs          , Gs^Fms      , Gll^Fp      , Gs          , Gs          , Gs          , Gs          , Gs          
Gg^Eff      , Gg          , Gg          , Gs^Dr       , Rp          , Rp          , Ww          , Ww          , Wo          , Ww^Es       , Rrc         , Rp^Vhcr     , Gg          , Gd^Xff      , Rrc         , Rrc         , Rrc         , Chr         , Rr^Dr       , Chr         , Rrc         , Rrc         , Rrc         , Rrc         , Rp^Vhcr     , Rrc         , Ww          , Ww          , Rp          , Gg          , Re          , Gg          , Gg          , Gll^Fp      , Gs^Fms      , Gs^Fds      , Wwf         , Gg^Fet      , Wwf         , Gs^Fds      , Gll^Fp      , Gs          , Gs          , Gs          , Gs          , Gll^Fp      , Gs          , Gs          
Gg^Eff      , Gg^Eff      , Rp          , Rp          , Ww          , Ww          , Wo          , Wo          , Ww          , Ww          , Rrc         , Rrc         , Rrc         , Rrc         , Rp^Vhcr     , Gg          , Gg          , Rrc         , Rrc         , Rrc         , Gg          , Gg          , Gg          , Gg          , Gg          , Rr^Dr       , Ww          , Ww          , Rp          , Re          , Gg          , Gg          , Gs^Fms      , Gs          , Gs          , Gs^Fds      , Gs^Fds      , Wwf         , Gs^Fds      , Gs^Fds      , Gs^Fms      , Gs          , Gll^Fp      , Gs^Fms      , Gs          , Gs          , Gs          , Gs          
Gg          , Re^Dr       , Rp          , Ww          , Ww          , Ww          , Ww          , Wo          , Ww          , Rrc         , Gg          , Gd^Xff      , Rrc         , Gg          , Gg          , Gg          , Gg^Dr       , Rrc         , Gg          , Gg^Dr       , Gd^Xff      , Gg          , Rrc^Xfv     , Gd^Xff      , Gg          , Rr^Dr       , Ww          , Ww          , Rp          , Re^Dr       , Re          , Gg          , Gll^Fp      , Gll^Fp      , Gs          , Gll^Fp      , Gll^Fp      , Gs^Fds      , Gs          , Gs^Fms      , Gs          , Gs          , Gll^Fp      , Gs          , Gs^Fms      , Gll^Fp      , Gs          , Gs          
Gs^Dr       , Rp          , Ww          , Ww          , Ww          , Rrc         , Rrc         , Ww          , Ww          , Rrc         , Gg^Dr       , Gg          , Rrc         , Gg          , Gg^Dr       , Gs^Fdw      , Gs^Fdw      , Rrc         , Gg          , Gd^Xff      , Gd^Xff      , Gg          , Gd^Xff      , Gd^Xff      , Gg          , Rrc         , Ww          , Ww          , Re          , Re^Dr       , Re          , Gg          , Gg          , Gs          , Gs^Fms      , Gs          , Gs^Fms      , Gs          , Gs^Fms      , Gs          , Gll^Fp      , Gs          , Gs          , Gs          , Gs          , Gs          , Gs          , Gs          
Rp          , Rp          , Ww          , Ww          , Rr^Dr       , Chr         , Rrc         , Ww          , Ww          , Chr         , Rrc         , Rrc         , Gg          , Rrc         , Rrc         , Gs^Fds      , Rrc         , Rrc         , Rrc         , Gg          , Gg          , Gg          , Gg          , Rp^Vhcr     , Rr^Dr       , Rr^Dr       , Ww          , Ww          , Ww          , Re          , Rp          , Gg          , Gg          , Gg          , Gg          , Gg          , Gg          , Gs          , Gg          , Gll^Fp      , Gg          , Gs          , Gs^Fms      , Gll^Fp      , Re^Vct      , Gs^Fms      , Gg          , Gs          
Ww          , Ww          , Ww          , Ww          , Gg          , Gg          , Rrc         , Ww          , Ww^Es       , Ww^Es       , Chr         , Gg          , Gd^Xff      , Rrc^Xfv     , Gd^Xff      , Rrc         , Gg          , Rp^Vhcr     , Gg          , Rrc         , Rrc         , Chr         , Chr         , Rrc         , Ww          , Ww          , Ww          , Wo          , Wo          , Ww          , Gg          , Rp          , Gg          , Gg          , Gs^Fds      , Gg          , Gs^Fds      , Gg          , Gg          , Gg          , Gs^Fds      , Gg          , Gg          , Re^Vct      , 1 Ke        , Ce          , Gg          , Gg          
Ww          , Wo          , Ww          , Chr         , Gg^Dr       , Rrc^Dr      , Rrc         , Ww^Es       , Wo          , Ww          , Ww          , Chr         , Rrc         , Gd^Xff      , Chr         , Rrc         , Chr         , Gg          , Rrc         , Rr^Dr       , Ww          , Ww^Bsb\     , Ww^Bsb\     , Ww          , Ww          , Ww          , Chr         , Ww          , Ww          , Ww          , Gg          , Rp          , Gg          , Gg          , Gs^Fds      , Gg          , Gg          , Gs^Fds      , Gg          , Gs^Fds      , Gg          , Gg          , Gs^Fds      , Ce          , Ce          , Ce          , Gg          , Gg          
Ww          , Wo          , Ww          , Rr^Dr       , Rrc         , Rrc         , Rrc         , Ww          , Ww          , Wo          , Ww          , Ww          , Ww          , Ch          , Ww          , Ww^Es       , Ww          , Chr         , Ww          , Ww          , Wo          , Wo          , Ww          , Ww^Bsb\     , Rrc         , Gg^Dr       , Rrc         , Rrc         , Ww          , Ww          , Gg          , Rp          , Gg          , Gg          , Gg          , Gg          , Gs^Fds      , Gg          , Gs^Fds      , Gg          , Gg          , Gs^Fds      , Gg          , Gg          , Gs^Fds      , Re^Vct      , Gg          , Gg          
Rp          , Ww          , Ww          , Ww          , Rr^Dr       , Rr^Dr       , Chr         , Rrc         , Rrc         , Ww          , Ww          , Wo          , Wo          , Ww          , Wo          , Ww^Es       , Ww          , Ww          , Ww          , Wo          , Wo          , Ww          , Chr         , Rrc         , Gg          , Rrc         , Rrc         , Rr^Dr       , Ww          , Ww          , Rp          , Rp          , Gg          , Gg          , Gs^Fds      , Gg          , Gg          , Gg          , Gg          , Gs^Fds      , Gg          , Gg          , Gg          , Gg          , Gg          , Gs^Fds      , Gg          , Gg          
Hh          , Rp          , Ww          , Ww          , Ww          , Chr^Dr      , Chr         , Rr^Dr       , Rrc         , Rr^Dr       , Ww          , Ww          , Ww          , Wo          , Ww          , Ww^Es       , Ww          , Wo          , Wo          , Ww          , Ww          , Ww          , Rrc         , Rrc         , Gg^Dr       , Gg          , Rrc         , Ww          , Wo          , Ww          , Gg          , Rp          , Gg          , Gg          , Gs^Fds      , Gs^Fds      , Gg          , Gs^Fds      , Gg          , Gg          , Gs^Fds      , Gs^Fds      , Gg          , Gs^Fds      , Gg          , Gg          , Gg          , Gg          
Mm          , Hhd         , Hhd         , Ww          , Ww          , Ww          , Ww          , Ww          , Ww          , Ww          , Ww          , Ww          , Rp          , Ww          , Rp          , Rp          , Re          , Ww          , Ww          , Wo          , Ww          , Ww          , Ww          , Rr^Dr       , Chr         , Gg          , Rrc         , Ww          , Ww          , Ww          , Gg          , Rp          , Gg          , Gg          , Gg          , Gg          , Gg          , Gs^Fds      , Gs^Fds      , Gg          , Gg          , Gg          , Gg          , Gs^Fds      , Gg          , Gs^Fds      , Gg          , Gg          
Mm          , Mm          , Hhd         , Gg          , Gg          , Ww          , Ww          , Wo          , Ww          , Ww          , Gg          , Rp          , Gg          , Rp^Dr       , Gg          , Re          , Re^Dr       , Re          , Ww          , Wo          , Ww          , Wo          , Ww          , Chr         , Chr         , Rr^Dr       , Ww          , Ww          , Ww          , Gg          , Rp          , Rp          , Gg          , Gs^Fds      , Gs^Fds      , Gg          , Gs^Fds      , Gg          , Gg          , Gg          , Gs^Fds      , Gg          , Gg          , Gg          , Gg          , Gg          , Gg          , Gg          
Mm          , Mm          , Mm          , Hh          , Hh          , Gg          , Gg          , Ww          , Gg          , Gg          , Re          , Re          , Re^Dr       , Gg          , Re          , Re^Dr       , Re^Dr       , Gg          , Gg          , Ww          , Ww          , Wo          , Wo          , Ww          , Ww          , Ww          , Wo          , Ww          , Gg          , Rp          , Gg          , Gg          , Gg          , Gg          , Gs^Fds      , Gg          , Gs^Fds      , Gg          , Gg          , Gs^Fds      , Gg          , Gg          , Gg          , Gg          , Gg          , Gg          , Gg          , Gg          
Mm^Xm       , Mm          , Mm          , Mm          , Hh          , Gg          , Gd^Xff      , Gg          , Gd^Xff      , Gg          , Gg          , Re^Dr       , Re^Dr       , Re^Dr       , Re          , Re^Dr       , Gg          , Gg          , Gd^Xff      , Gg          , Gg          , Ww          , Ww          , Wo          , Wo          , Ww          , Ww          , Ww          , Gg          , Re^Dr       , Gg          , Gg          , Gs^Fds      , Gg          , Gg          , Gg          , Gg          , Gs^Fds      , Gg          , Gg          , Gg          , Gg          , Gg          , Gg          , Gg          , Gg          , Gg          , Gg          
Mm          , Mm^Xm       , Mm          , Mm          , Hhd         , Gg          , Gd^Xff      , Gd^Xff      , Gd^Xff      , Gg          , Gg          , Gg          , Gg          , Re          , Gg          , Gg          , Gg          , Gd^Xff      , Gd^Xff      , Gd^Xff      , Gd^Xff      , Gg          , Gg          , Ww          , Ww          , Wo          , Wo          , Ww          , Ww          , Gg          , Gg          , Gs^Fds      , Gs^Fds      , Gg          , Gs^Fds      , Gg          , Gg          , Gg          , Gg          , Gg          , Gg          , Gg          , Gg          , Gg          , Gg          , Gg          , Gg          , Gg          
Mm          , Mm          , Hh          , Mm          , Hhd         , Gg          , Gg          , Gs          , Gs          , Gg          , Gg          , Gs          , Gs          , Gg          , Gg          , Gs^Fms      , Gg          , Gg          , Gs          , Gd^Xff      , Gs          , Gg          , Gg          , Gs          , Gs          , Ww          , Ww          , Ww          , Wo          , Ww          , Ww          , Gg          , Gg          , Gg          , Gs^Fds      , Gs^Fds      , Gg          , Gg          , Gg          , Gg          , Gg          , Gg          , Gg          , Gg          , Gg          , Gg          , Gg          , Gg          
Hh          , Mm          , Hh          , Hh          , Gg          , Gg          , Gg          , Gs          , Gs^Fms      , Gg          , Gg          , Gd^Xff      , Gd^Xff      , Gg          , Gs          , Gs^Fms      , Gs^Fms      , Gg          , Gg          , Gs          , Gg          , Gg          , Gs^Fms      , Gs^Fms      , Gs          , Gg          , Gg          , Ww          , Ww          , Wo          , Ww          , Ww          , Ww          , Gg          , Gg          , Gg          , Gg          , Gs^Fds      , Gg          , Gg          , Gg          , Gg          , Gg          , Gg          , Gg          , Gg          , Gg          , Gg          
Mm          , Mm          , Mm          , Hh          , Hh          , Gg          , Gs          , Gs^Fms      , Gs^Fms      , Gg          , Gg          , Gg          , Gd^Xff      , Gd^Xff      , Gs          , Gg          , Gg          , Gg          , Gs^Fms      , Gs^Fms      , Gg          , Gs          , Gs          , Gs^Fms      , Gs          , Gg          , Gg          , Gg          , Gs          , Ww          , Ww          , Wo          , Ww          , Gg          , Gg          , Gg          , Gg          , Gg          , Gg          , Gg          , Gg          , Gg          , Gg          , Gg          , Gg          , Gg          , Gg          , Gg          
Mm^Xm       , Mm          , Mm          , Mm          , Hhd         , Gg          , Gs          , Gs          , Gg          , Gg          , Gg          , Gs          , Gs          , Gs          , Gs^Fms      , Gg          , Gg          , Gs^Fms      , Gs^Fms      , Gg          , Gs^Fms      , Gg          , Gg          , Gg          , Gg          , Gg          , Gg          , Gs^Fms      , Gs^Fms      , Gs          , Ww          , Wo          , Ww          , Gg          , Gg          , Gg          , Gg          , Gg          , Gg          , Gg          , Gg          , Gg          , Gg          , Gg          , Gg          , Gg          , Gg          , Gg          
