border_size=1
usage=map

Xol         , Xos         , Xos         , Xos         , Xos         , Xos         , Xos         , Xos         , Xos         , Iwr         , Iwr         , Iwr         , Iwr         , Iwr         , Xos         , Xos         , Xos         , Xos         , Xos         , Xos         , Xos         , Xos         , Xol         
Iwr         , Xol         , Xol         , Xos         , Xos         , Xos         , Xos         , Xos         , Xos         , Iwr         , Iwr         , Iwr         , Iwr         , Iwr         , Xos         , Xos         , Xos         , Xos         , Xos         , Xos         , Xol         , Xol         , Iwr         
Iwr         , Iwr         , Iwr         , Xol         , Xol         , Xos         , Xos         , Xos         , Xos         , Iwr         , Iwr         , Iwr         , Iwr         , Iwr         , Xos         , Xos         , Xos         , Xos         , Xol         , Xol         , Iwr         , Iwr         , Iwr         
Xos         , Iwr         , Iwr         , Iwr         , Iwr         , Xol         , Xol         , Xos         , Xos         , Xos         , Iwr         , Iwr         , Iwr         , Xos         , Xos         , Xos         , Xol         , Xol         , Iwr         , Iwr         , Iwr         , Iwr         , Xos         
Xos         , Xos         , Xos         , Iwr         , Iwr         , Iwr         , Iwr         , Xos         , Xol         , Xol         , Iwr         , Iwr         , Iwr         , Xol         , Xol         , Xos         , Iwr         , Iwr         , Iwr         , Iwr         , Xos         , Xos         , Xos         
Xos         , Xos         , Xos         , Xos         , Xos         , Iwr         , Iwr^Xz/     , Xol         , Iwr         , Iwr         , Iwr         , Iwr         , Iwr         , Iwr         , Iwr         , Xol         , Iwr^Iz\     , Iwr         , Xos         , Xos         , Xos         , Xos         , Xos         
Xos         , Xos         , Xos         , Xos         , Xol         , Xol         , Iwr         , Iwr         , Ch          , Iwr         , Iwr         , Iwr         , Iwr         , Iwr         , Ch          , Iwr         , Iwr         , Xol         , Xol         , Xos         , Xos         , Xos         , Xos         
Xos         , Xos         , Xos         , Xol         , Iwr         , Iwr         , Iwr         , Iwr         , Iwr         , Iwr         , Iwr         , Iwr         , Iwr         , Iwr         , Iwr         , Iwr         , Iwr         , Iwr         , Iwr         , Xol         , Xos         , Xos         , Xos         
Xos         , Xos         , Xos         , Iwr         , Iwr         , Ch          , Iwr         , Iwr         , Iwr         , Iwr         , Ycp         , Ycp         , Ycp         , Iwr         , Iwr         , Iwr         , Iwr         , Ch          , Iwr         , Iwr         , Xos         , Xos         , Xos         
Xos         , Xos         , Xos         , Iwr         , Iwr         , Iwr         , Iwr         , Iwr         , Ycp         , Ycp         , Ch          , Ch          , Ch          , Ycp         , Ycp         , Iwr         , Iwr         , Iwr         , Iwr         , Iwr         , Xos         , Xos         , Xos         
Xos         , Xos         , Xos         , Iwr         , Iwr         , Iwr         , Iwr         , Ycp         , Ycp         , Ycp         , Ch          , Ch          , Ch          , Ycp         , Ycp         , Ycp         , Iwr         , Iwr         , Iwr         , Iwr         , Xos         , Xos         , Xos         
Xos         , Xos         , Xos         , Iwr         , Iwr         , Iwr         , Iwr         , Iwr         , Iwr         , Ycp         , Ycp         , Ch          , Ycp         , Ycp         , Iwr         , Iwr         , Iwr         , Iwr         , Iwr         , Iwr         , Xos         , Xos         , Xos         
Xos         , Xos         , Xos         , Iwr         , Iwr         , Iwr         , Iwr         , Iwr         , Iwr         , Iwr         , Iwr         , Ycp         , Iwr         , Iwr         , Iwr         , Iwr         , Iwr         , Iwr         , Iwr         , Iwr         , Xos         , Xos         , Xos         
Xos         , Xos         , Xos         , Iwr         , Iwr         , Ch          , Iwr         , Iwr         , Iwr         , Iwr         , Iwr         , Iwr         , Iwr         , Iwr         , Iwr         , Iwr         , Iwr         , Ch          , Iwr         , Iwr         , Xos         , Xos         , Xos         
Xos         , Xos         , Xos         , Iwr         , Iwr         , Iwr         , Iwr         , Iwr         , Iwr         , Iwr         , Iwr         , Iwr         , Iwr         , Iwr         , Iwr         , Iwr         , Iwr         , Iwr         , Iwr         , Iwr         , Xos         , Xos         , Xos         
Xos         , Xos         , Xos         , Xos         , Xos         , Iwr         , Iwr         , Iwr         , Ch          , Iwr         , Iwr         , Iwr         , Iwr         , Iwr         , Ch          , Iwr         , Iwr         , Iwr         , Xos         , Xos         , Xos         , Xos         , Xos         
Xos         , Xos         , Xos         , Xos         , Xol         , Xol         , Iwr^Xz\     , Iwr         , Iwr         , Iwr         , Iwr         , Iwr         , Iwr         , Iwr         , Iwr         , Iwr         , Iwr^Iz/     , Xol         , Xol         , Xos         , Xos         , Xos         , Xos         
Xos         , Xos         , Xol         , Xol         , Iwr         , Iwr         , Iwr         , Xos         , Xos         , Iwr         , Iwr         , Iwr         , Iwr         , Iwr         , Xos         , Xos         , Iwr         , Iwr         , Iwr         , Xol         , Xol         , Xos         , Xos         
Xol         , Xol         , Iwr         , Iwr         , Iwr         , Iwr         , Xos         , Xos         , Xos         , Xos         , Iwr         , Iwr         , Iwr         , Xos         , Xos         , Xos         , Xos         , Iwr         , Iwr         , Iwr         , Iwr         , Xol         , Xol         
Iwr         , Iwr         , Iwr         , Iwr         , Xos         , Xos         , Xos         , Xos         , Xos         , Xos         , Iwr         , Iwr         , Iwr         , Xos         , Xos         , Xos         , Xos         , Xos         , Xos         , Iwr         , Iwr         , Iwr         , Iwr         
Iwr         , Iwr         , Xos         , Xos         , Xos         , Xos         , Xos         , Xos         , Xos         , Iwr         , Iwr         , Iwr         , Iwr         , Iwr         , Xos         , Xos         , Xos         , Xos         , Xos         , Xos         , Xos         , Iwr         , Iwr         
Xos         , Xos         , Xos         , Xos         , Xos         , Xos         , Xos         , Xos         , Xos         , Iwr         , Iwr         , Iwr         , Iwr         , Iwr         , Xos         , Xos         , Xos         , Xos         , Xos         , Xos         , Xos         , Xos         , Xos         
Xos         , Xos         , Xos         , Xos         , Xos         , Xos         , Xos         , Xos         , Xos         , Iwr         , Iwr         , Iwr         , Iwr         , Iwr         , Xos         , Xos         , Xos         , Xos         , Xos         , Xos         , Xos         , Xos         , Xos         
