border_size=1
usage=map

Gg          , Gg          , Gg          , Gg          , Gs^Fds      , Rr          , Rr          , Gg          , Gg          , Gg          , Gs^Fds      , Gs^Fds      , Gs^Fds      , Gs^Fds      , Gs^Fds      , Gg          , Gs^Fds      , Gg          , Gg          , Gg          , Rr          , Gg          , Gg          
Gg          , Gg          , Gg          , Gs^Fds      , Gs^Fds      , Gg          , Gg          , Rr          , Rr          , Gg          , Gg          , Gg          , Gg          , Gg          , Gg          , Gs^Fds      , Rr^Vhc      , Gg          , Rr          , Rr          , Gg          , Gg          , Gg          
Gg          , Gg          , Rr^Vhc      , Gs^Fds      , Gg          , Rr^Vhc      , Gg          , Rr          , Rr          , Gg          , Ch          , Ch          , Ch          , Gg          , Rr          , Rr          , Rr          , Rr          , Gg          , Gg          , Gg          , Gg          , Gg          
Gg          , Gs^Fds      , Gs^Fds      , Gs^Fds      , Gg          , Gg          , Gg          , Gg          , Ch          , Rr          , Rr          , Kh          , Rr          , Rr          , Ch          , Gg          , Gg          , Gg          , Gs^Fds      , Gs^Fds      , Gg          , Gg          , Gg          
Gg          , Gg          , Gs^Fds      , Gs^Fds      , Gg          , Gg          , Gg          , Ch          , Kh          , Rr          , Rrc         , Rrc         , Rrc         , Rr          , Kh          , Ch          , Gg          , Gg          , Gs^Fds      , Rr^Vhc      , Gg          , Gg          , Gg          
Gg          , Gs^Fds      , Gg          , Gg          , Rr          , Rr          , Rr          , Ch          , Rr          , Rrc         , Ch          , Ch          , Ch          , Rrc         , Rr          , Ch          , Gg          , Gg          , Gs^Fds      , Gs^Fds      , Gg          , Gg          , Gg          
Gg          , Gs^Fds      , Gg          , Rr          , Gg          , Rr          , Gg          , Rr          , Rr          , Rrc         , Ch          , 1 Kh        , Ch          , Rrc         , Rr          , Rr          , Rr          , Gg          , Gg          , Gg          , Gg          , Gg          , Gg          
Rr          , Gg          , Rr          , Rr          , Gg          , Gg          , Gg          , Ch          , Kh          , Rrc         , Rrc         , Ch          , Rrc         , Rrc         , Kh          , Ch          , Rr          , Gg          , Gg          , Gg          , Rr          , Gg          , Gg          
Gg          , Rr          , Gs^Fds      , Gs^Fds      , Gs^Fds      , Gg          , Gg          , Ch          , Ch          , Rr          , Rr          , Rrc         , Rr          , Rr          , Ch          , Ch          , Rr          , Rr          , Rr          , Rr          , Gg          , Rr          , Rr          
Gg          , Gg          , Gs^Fds      , Gs^Fds      , Gg          , Gs^Fds      , Gg          , Gg          , Rr          , Rr          , Ch          , Kh          , Ch          , Rr          , Rr          , Gg          , Gg          , Gg          , Gs^Fds      , Gg          , Gg          , Gg          , Gg          
Gg          , Gg          , Gs^Fds      , Rr^Vhc      , Gg          , Gg          , Rr          , Rr          , Rr          , Gg          , Gg          , Ch          , Gg          , Gg          , Gg          , Rr          , Gg          , Gs^Fds      , Rr^Vhc      , Gs^Fds      , Gg          , Gg          , Gg          
Gg          , Gs^Fds      , Gs^Fds      , Gs^Fds      , Gg          , Gg          , Rr          , Gg          , Gg          , Gg          , Rr^Vhc      , Gs^Fds      , Gs^Fds      , Gs^Fds      , Gs^Fds      , Rr          , Rr          , Gs^Fds      , Gs^Fds      , Gs^Fds      , Gg          , Gg          , Gg          
Gg          , Gg          , Gg          , Gg          , Gg          , Rr          , Gg          , Gg          , Gg          , Gg          , Gs^Fds      , Gs^Fds      , Gg          , Gs^Fds      , Gg          , Gg          , Gg          , Rr          , Rr          , Gg          , Gg          , Gg          , Gg          
