border_size=1
usage=map

Rb          , Rb          , Ss          , Rb          , Ds          , Rb          , Ss          , Rb          , Gg          , Ss          , Rb          , Gg          , Gg          , Ss          , Ss          , Gg          , Gg          , Ss          , Ds          , Ss          , Gg          , Rb          , Ds          , Ss          , Ss          , Gg          , Ss          , Rb          , Gg          , Ss          , Gg          , Gg          , Gg          , Gg          , Gg          , Ss          , Ds          , Gg          , Gg          , Gg          , Ss          , Gg          , Gg          , Ss          , Gg          , Rb          
Gg          , Rb          , Ss          , Ss          , Rb          , Ds          , Gg          , Gg          , Rb          , Gg          , Gll^Fp      , Ds          , Ss          , Ss          , Ds          , Ds          , Ss          , Gg          , Ss          , Gg          , Gll^Fp      , Gg          , Ds          , Gg          , Ss          , Gg          , Ss          , Ss          , Gll^Fp      , Ss          , Gg          , Rb          , Ss          , Gll^Fp      , Ss          , Gll^Fp      , Ds          , Ss          , Gg          , Gg          , Gg          , Ss          , Ss          , Ss          , Gg          , Gll^Fp      
Gg          , Gg          , Gg          , Ds          , Rb          , Gg          , Ss          , Ss          , Ss          , Gg          , Ss          , Ss          , Rb          , Ds          , Ds          , Gg          , Gg          , Gg          , Ss          , Ss          , Gg          , Ss          , Rb          , Gg          , Ds          , Rb          , Gg          , Ss          , Ds          , Rb          , Ss          , Gll^Fp      , Ss          , Gg          , Ss          , Ss          , Gg          , Gll^Fp      , Gll^Fp      , Ss          , Ss          , Ss          , Ss          , Gg          , Ss          , Gg          
Ds          , Ss          , Ds          , Gll^Fp      , Gg          , Rb          , Ce          , Ce          , Ce          , Ds          , Rb          , Gg          , Gg          , Ss          , Rb          , Ss          , Rb          , Gll^Fp      , Ss          , Rb          , Ss          , Gg          , Ds          , Gg          , Ss          , Gll^Fp      , Gg          , Ss          , Rb          , Ds          , Rb          , Gg          , Gg          , Ss          , Gll^Fp      , Gg          , Ss          , Ss          , Ss^Srst     , Rb^Srot     , Gg^Srgt     , Gll^Fp      , Ss          , Gg          , Ss          , Ss          
Rb          , Gg          , Gg          , Rb          , Gg          , Rb          , Ce          , 1 Ke        , Ce          , Ds          , Ss          , Gg          , Gll^Fp      , Rb          , Gll^Fp      , Ss          , Ds          , Ss          , Ss          , Ss          , Ss          , Gg          , Rb          , Ds          , Ss          , Gg          , Ss          , Ss          , Gg          , Rb          , Gg          , Ss          , Gg          , Gll^Fp      , Gg          , Ss          , Gg          , Ss          , Gg^Srjt     , 4 Gg^Sct    , Ss^Srat     , Ss          , Ss          , Gg          , Gg          , Rb          
Gg          , Gg          , Ds          , Ss          , Rb          , Ss          , Rb          , Ce          , Ss          , Ss          , Gg          , Gg          , Gg          , Rb          , Rb          , Gg          , Ce          , Ds          , Rb          , Gg          , Ss          , Gg          , Ss          , Gg          , Gg          , Ss          , Ss          , Gll^Fp      , Ss          , Gll^Fp      , Ss          , Ds          , Rb          , Gg          , Gg          , Gll^Fp      , Gg          , Rb          , Gll^Fp      , Gg^Srjl     , Gg          , Ss          , Gll^Fp      , Gll^Fp      , Gll^Fp      , Rb          
Gg          , Ds          , Ds          , Gg          , Ds          , Gg          , Gg          , Ss          , Gg          , Gg          , Ds          , Ss          , Gg          , Gg          , Ce          , 3 Ke        , Ce          , Rb          , Ss          , Ss          , Ss          , Gg          , Rb          , Ss          , Rb          , Gll^Fp      , Ss          , Gll^Fp      , Rb          , Ss          , Ss          , Ss          , Gg          , Gll^Fp      , Gll^Fp      , Gg          , Ds          , Gg          , Gg          , Gll^Fp      , Gll^Fp      , Ss          , Gg          , Ss          , Gg          , Rb          
Gg          , Rb          , Rb          , Ds          , Gg          , Gll^Fp      , Ss          , Gg          , Rb          , Ss          , Gll^Fp      , Gg          , Ss          , Rb          , Gg          , Ce          , Ss          , Rb          , Gg          , Ss          , Gg          , Gll^Fp      , Ss          , Ss          , Gg          , Ds          , Ss          , Ss          , Ss          , Gg          , Gll^Fp      , Gg          , Ss          , Gg          , Gg          , Gg          , Gg          , Ss          , Gg          , Gg          , Ss          , Ss          , Gg          , Ss          , Gg          , Ds          
Ds          , Gg          , Gg          , Rb          , Ce          , Rb          , Rb          , Ds          , Gg          , Ss          , Gg          , Ds          , Ds          , Ss          , Rb          , Ds          , Gg          , Ds          , Gg          , Gll^Fp      , Ds          , Rb          , Rb          , Ss          , Gll^Fp      , Ss          , Gg          , Ss          , Rb          , Ss          , Gg          , Gg          , Rb          , Ss          , Gg          , Gg          , Ss          , Rb          , Ss          , Ss          , Rb          , Ss          , Ss          , Rb          , Ss          , Ss          
Rb          , Gg          , Gg          , Gg          , Ce          , 2 Ke        , Ce          , Rb          , Ss          , Gg          , Ds          , Gg          , Ss          , Gg          , Ds          , Ss          , Gg          , Ss          , Ss          , Ss          , Ss          , Rb          , Gg          , Gll^Fp      , Rb          , Rb          , Ss          , Gg          , Gg          , Ss          , Gg          , Gg          , Ss          , Ss          , Ss          , Ss          , Rb          , Ss          , Ss          , Rb          , Gll^Fp      , Gll^Fp      , Ss          , Gg          , Gg          , Gg          
Ss          , Gg          , Ds          , Rb          , Ds          , Ce          , Gg          , Ds          , Rb          , Gg          , Ds          , Gg          , Gg          , Rb          , Gg          , Gg          , Ds          , Ss          , Gg          , Rb          , Rb          , Rb          , Ss          , Ss          , Ds          , Gll^Fp      , Rb          , Ss          , Gg          , Ds          , Rb          , Gg          , Gg          , Rb          , Gll^Fp      , Ss          , Gll^Fp      , Ss          , Rb          , Gll^Fp      , Ss          , Gll^Fp      , Gg          , Ss          , Gg          , Ss          
Rb          , Ds          , Ds          , Gg          , Rb          , Ss          , Ds          , Ss          , Gg          , Ds          , Rb          , Rb          , Ss          , Ss          , Ss          , Ss          , Gg          , Ss          , Gg          , Gg          , Ss          , Gg          , Gg          , Gg          , Ss          , Ds          , Ss          , Ss          , Gg          , Gll^Fp      , Gll^Fp      , Gg          , Rb          , Gll^Fp      , Gll^Fp      , Gll^Fp      , Ss          , Gg          , Ss          , Ss          , Ss          , Ss          , Rb          , Rb          , Gg          , Gg          
Rb          , Ss          , Gg          , Gg          , Rb          , Gg          , Ds          , Gg          , Gg          , Gg          , Gg          , Ds          , Gg          , Gg          , Gg          , Ss          , Gg          , Rb          , Rb          , Ss          , Ss          , Ss          , Gg          , Gg          , Gg          , Gg          , Gg          , Gg          , Ss          , Gg          , Gg          , Rb          , Gg          , Gg          , Gll^Fp      , Gg          , Ss          , Rb          , Ss          , Ss          , Ss          , Gg          , Gg          , Ss          , Rb          , Ds          
Gg          , Ss          , Ss          , Ds          , Ss          , Ds          , Gg          , Rb          , Rb          , Ss          , Gg          , Gg          , Gg          , Gg          , Rb          , Gg          , Ds          , Ss          , Ss          , Ss          , Gll^Fp      , Rb          , Ss          , Ss          , Gll^Fp      , Ds          , Ss          , Ds          , Ss          , Ss          , Ss          , Gg          , Ds          , Gll^Fp      , Gg^Sra      , Gg^Srjs     , Gg^Srg      , Gg          , Gg          , Gg          , Ds          , Ss          , Rb          , Ss          , Rb          , Gll^Fp      
Rb          , Gg          , Ss          , Ss          , Gg          , Gg          , Gll^Fp      , Gg          , Gg          , Ss          , Ss          , Ss          , Ds          , Rb          , Ss          , Gg          , Rb          , Rb          , Gg          , Gll^Fp      , Gll^Fp      , Ds          , Gg          , Ds          , Gg          , Ss          , Gg          , Ss          , Gg          , Gll^Fp      , Ss          , Rb          , Gg          , Gll^Fp      , Gg^Srj      , 7 Gg^Sc     , Gg^Sro      , Ss          , Ss          , Gll^Fp      , Ss          , Ss          , Rb          , Gg          , Gll^Fp      , Ss          
Ds          , Rb          , Gll^Fp      , Ds          , Ss          , Ss          , Ds          , Ss          , Gg          , Rb          , Gg          , Ss          , Rb          , Gg          , Ss          , Ss          , Gg          , Rb          , Rb          , Ds          , Ss          , Rb          , Ss          , Ss          , Gg          , Gg          , Gg          , Gg          , Gg          , Gg          , Ds          , Rb          , Ss          , Ss          , Ss          , Gg^Srs      , Gll^Fp      , Ss          , Ss          , Ss          , Gg          , Gll^Fp      , Ss          , Gg          , Rb          , Gg          
Gg          , Rb          , Gg          , Rb          , Gg          , Ss          , Ds          , Rb          , Gg          , Gg          , Gg          , Ss          , Ss          , Gg          , Gg          , Ss          , Rb          , Gg          , Gg          , Gg          , Rb          , Ss          , Rb          , Gg          , Gg          , Rb          , Ds          , Gg          , Gll^Fp      , Gg          , Gll^Fp      , Rb          , Gg          , Ds          , Gll^Fp      , Gg          , Ss          , Ss          , Ss          , Gg          , Gll^Fp      , Ss          , Rb          , Gg          , Gg          , Gg          
Gg          , Gg          , Rb          , Ds          , Gg          , Rb          , Ds          , Rb          , Ss          , Ss          , Gg          , Gll^Fp      , Ss          , Gg          , Ss          , Rb          , Gll^Fp      , Ss          , Ss          , Ds          , Ds          , Ss          , Gll^Fp      , Ss          , Gg          , Ss          , Gg          , Rb          , Gg          , Gg          , Gll^Fp      , Gg          , Gg          , Ss          , Gg          , Rb          , Rb          , Ss          , Ds          , Ss          , Gll^Fp      , Gg          , Gg          , Ss          , Rb          , Ds          
Rb          , Ss          , Rb          , Gg          , Ss          , Gg          , Ss          , Rb          , Rb          , Rb          , Rb          , Ss          , Ss          , Ss          , Gg          , Gll^Fp      , Ss          , Ss          , Gg          , Ds          , Ss          , Gg          , Ss          , Ss          , Gg          , Ss          , Gg          , Ss          , Ss          , Gll^Fp      , Gll^Fp      , Ss          , Gg          , Gll^Fp      , Gg          , Ss          , Rb          , Gg          , Gg          , Ss          , Rb          , Ss          , Gg          , Gg          , Gg          , Ss          
Gg          , Ss          , Rb          , Gg          , Rb          , Rb          , Rb          , Rb          , Ss          , Gg          , Rb          , Ss          , Gg          , Rb          , Gg          , Rb          , Rb          , Ds          , Gg          , Rb          , Gg          , Gg          , Ss          , Ss          , Ss          , Gg          , Ds          , Rb          , Gg          , Gg          , Gg          , Ss          , Gll^Fp      , Rb          , Gg          , Ss          , Ss          , Ss          , Ss          , Gg          , Gll^Fp      , Ss          , Gll^Fp      , Gg          , Gg          , Ss          
Gg          , Ss          , Gg          , Ss          , Gg          , Ds          , Ss          , Rb          , Gg          , Ds          , Gg          , Ss          , Gg          , Gg          , Ss          , Gll^Fp      , Gg          , Rb          , Gg          , Ds          , Gg          , Ss          , Ss          , Gg          , Ss          , Gg          , Gll^Fp      , Rb          , Gg          , Ss          , Gll^Fp      , Gg          , Ss          , Gg          , Gg          , Ss          , Ss          , Gg          , Gg          , Gll^Fp      , Gg          , Rb          , Ds          , Ds          , Ss          , Ss          
Gg          , Ds          , Gg          , Rb          , Gg          , Gg          , Gg          , Ss          , Gg          , Gll^Fp      , Gg          , Ss          , Gg          , Gg          , Gg          , Gg          , Ds          , Gg          , Ss          , Gg          , Ss          , Gg          , Gll^Fp      , Ss          , Gll^Fp      , Ss          , Gg^Srjl     , Rb^Srgt     , Gg^Srot     , Ss          , Ss          , Ss          , Gg          , Rb          , Ds          , Gll^Fp      , Gg          , Gg          , Ss          , Ss          , Rb          , Gg          , Ds          , Gg          , Ds          , Gg          
Ss          , Ds          , Gg          , Gg          , Rb          , Ss          , Ds          , Rb          , Gg          , Gg          , Ds          , Ds          , Gg          , Gg          , Gg          , Gg          , Gg          , Gg          , Ss          , Gg          , Ds          , Gg          , Ss          , Rb          , Gll^Fp      , Ss          , Gg^Srjt     , 6 Rb^Sct    , Gg^Srjl     , Ss          , Gg          , Gg          , Ss          , Ss          , Ss          , Ss          , Ss          , Gll^Fp      , Gg          , Gg          , Gll^Fp      , Ds          , Gg^Srg      , Gll^Fp      , Gg^Srjs     , Ss          
Gg          , Ds          , Ss          , Gg          , Ds          , Rb          , Rb          , Gg          , Rb          , Ds          , Rb          , Gg          , Ss          , Ss          , Gg          , Ds          , Rb          , Ss          , Gg          , Gll^Fp      , Gg          , Ss          , Rb          , Gg          , Gg          , Ss          , Ss          , Ss^Srat     , Gll^Fp      , Ss          , Gll^Fp      , Gg          , Gg          , Ss          , Gg          , Rb          , Gg          , Rb          , Ss          , Ss          , Ss          , Ds          , Gg^Srjl     , 8 Rb^Sc     , Gg^Srot     , Ss          
Ss          , Ss          , Ss          , Ds          , Gg          , Ds          , Rb          , Rb          , Rb          , Gg          , Gg          , Gg          , Ss          , Ss          , Gg          , Gll^Fp      , Gg          , Ss          , Ss          , Ss          , Gg          , Ss          , Ss          , Ss          , Rb          , Ss          , Rb          , Gll^Fp      , Gg          , Gg          , Ss          , Gg          , Ss          , Ss          , Ss          , Gg          , Gg          , Ss          , Gg          , Gg          , Ss          , Ds          , Rb^Sra      , Gg^Srst     , Rb          , Gll^Fp      
Ss          , Gg          , Rb          , Gg          , Ss          , Ss          , Rb          , Rb          , Ss          , Gg          , Ss          , Ss          , Ds          , Rb          , Rb          , Gg          , Gg          , Gg          , Rb          , Gg          , Rb          , Ss          , Gg          , Ss          , Gll^Fp      , Ss          , Rb          , Ss          , Gll^Fp      , Gg          , Gll^Fp      , Gg          , Ds          , Ss          , Ss          , Ss          , Ss          , Ss          , Gg          , Ds          , Rb          , Gll^Fp      , Gg          , Gll^Fp      , Gll^Fp      , Gg          
Gg          , Gg          , Rb          , Gg          , Ss          , Gg          , Ss          , Gg          , Ds          , Ds          , Gg          , Ss          , Ss          , Ds          , Ss          , Ss          , Ss          , Ss          , Ss          , Gll^Fp      , Ds          , Ss          , Ss          , Ss          , Ss          , Ss          , Rb          , Gg          , Rb          , Gg          , Gg          , Ss          , Ss          , Gg          , Ds          , Gg          , Gg          , Gg          , Rb          , Gg          , Ss          , Ss          , Gg          , Gg          , Rb          , Ss          
Gll^Fp      , Ss          , Gg          , Ds          , Ss          , Ss          , Ss          , Gg          , Ss          , Gg          , Ss          , Ss          , Ss          , Rb          , Ss          , Ss          , Ss          , Ds          , Gll^Fp      , Ss          , Ss          , Ss          , Ss          , Ss          , Gll^Fp      , Ss          , Ss          , Ss          , Gg          , Gg          , Gg          , Gg          , Gg          , Ss          , Ss          , Ss          , Gg          , Gll^Fp      , Rb          , Gll^Fp      , Ss          , Ds          , Ss          , Ss          , Gll^Fp      , Gg          
Rb          , Rb          , Ss          , Ss          , Ss          , Gg          , Gg          , Gg          , Gll^Fp      , Gg          , Ss          , Rb          , Gg          , Gg          , Rb          , Ds          , Ds          , Ss          , Ss          , Gg          , Gll^Fp      , Gg          , Ds          , Gg          , Ss          , Rb          , Ss          , Ds          , Rb          , Gg          , Ss          , Gg          , Ds          , Rb          , Ss          , Gll^Fp      , Ds          , Ss          , Ss          , Rb          , Gll^Fp      , Ss          , Gg          , Rb          , Rb          , Ds          
Ss          , Gg          , Rb          , Ss          , Gg          , Ds          , Gll^Fp      , Gg          , Ds          , Gg          , Ss          , Rb          , Ss          , Gg          , Ds          , Rb          , Ss          , Ss          , Ss          , Gg          , Rb          , Rb          , Gg          , Ds          , Gg          , Gg          , Gg          , Gg          , Ss          , Gll^Fp      , Gg          , Ss          , Ss          , Gll^Fp      , Ss          , Gll^Fp      , Ds          , Ss          , Ss          , Gg          , Rb          , Ss          , Ss          , Gg          , Ss          , Ss          
Gg          , Ss          , Gg          , Gg          , Ss          , Ss          , Rb          , Gg          , Gg          , Ss          , Ss          , Ss          , Gg          , Gll^Fp      , Gg          , Gg          , Ss          , Ss          , Ss          , Ds          , Ss          , Ss          , Gg          , Gg          , Rb          , Gg          , Ss          , Ds          , Gg          , Gg          , Gg          , Ss          , Ds          , Gll^Fp      , Gg          , Ss          , Ss          , Rb          , Gll^Fp      , Gg          , Ss          , Ss          , Ss          , Ss          , Ss          , Gg          
Ss          , Gg          , Ss          , Rb          , Rb^Srs      , Ss          , Ds          , Gg          , Ss          , Ds          , Ds          , Gg          , Rb          , Ss          , Ds          , Gll^Fp      , Ss          , Ds          , Gll^Fp      , Gg          , Gg          , Rb          , Ss          , Ds          , Ss          , Gg          , Gll^Fp      , Ss          , Ss          , Gg          , Gg          , Gg          , Gg          , Ss          , Ss          , Ss          , Gg          , Ss          , Ss          , Rb          , Ds          , Gg          , Ss          , Gg          , Ss          , Gll^Fp      
Gg          , Gg          , Gg          , Gg^Sro      , 5 Rb^Sc     , Ds^Srjs     , Ss          , Ss          , Gg          , Ds          , Ss          , Gg          , Gg          , Gg          , Ds          , Ss          , Gg          , Rb          , Ds          , Ds          , Ds          , Gg          , Gg          , Gll^Fp      , Gll^Fp      , Gg          , Ss          , Gg          , Ds          , Rb          , Gg          , Ss          , Ss          , Gg          , Gll^Fp      , Ss          , Ss          , Ds          , Rb          , Ss          , Ss          , Ss          , Ss          , Gg          , Gg          , Ss          
Rb          , Ds          , Rb          , Gg^Srj      , Gg^Sra      , Gg^Srg      , Ss          , Ss          , Ss          , Gg          , Ss          , Ss          , Ss          , Ds          , Gg          , Ss          , Gll^Fp      , Ds          , Ds          , Ss          , Gg          , Ss          , Rb          , Ss          , Gg          , Rb          , Ss          , Ss          , Gg          , Ss          , Ss          , Gg          , Gll^Fp      , Ss          , Gg          , Gg          , Ss          , Ss          , Ds          , Ss          , Ss          , Gg          , Ss          , Ss          , Gg          , Gg          
Gg          , Ss          , Ss          , Gg          , Ss          , Ss          , Gg          , Gg          , Ss          , Gg          , Rb          , Gg          , Ss          , Ss          , Ss          , Gg          , Ss          , Gg          , Ss          , Ss          , Gll^Fp      , Ss          , Rb          , Gg          , Rb          , Rb          , Gll^Fp      , Gg          , Ss          , Ss          , Ss          , Gg          , Gll^Fp      , Gg          , Gll^Fp      , Gg          , Gg          , Gg          , Ss          , Ss          , Gll^Fp      , Ss          , Gg          , Ss          , Rb          , Gll^Fp      
