border_size=1
usage=map

Gg, Gg, Gll^Fp, Gg, Gg, Gll^Fp, Ss, Gll^Fp, Gg, Gg, Gll^Fp, Gg, Gg, Gll^Fp, Gg, Gg, Hh, Gg, Gll^Fp, Ss, Gg, Gg, Gg, Gg, Ss, Gg, Gg, Gg, Ss, Ss, Gg, Ds, Gll, Gll^Fp, Ss, Gg, Gll^Fp, Hh, Gg, Gg, Gg, Hh, Ss, Hh, Ss, Ss, Ww, Ww, Wo, Wo, Wo, Wo, Wo, Wo, Wo, Wo, Wo, Wo, Wo, Wo, Wo, Wo, Wo, Wo, Wo, Wo, Wo
Gll^Fp, Sm, Ds, Gg, Gll^Fp, Gg, Gg, Gg, Ss, Gg, Hh, Ds, Gll^Fp, Gg, Gg, Gll^Fp, Gg, Ds, Ss, Gg, Ss, Re^Vct, Gll^Fp, Gg, Ss, Sm, Hh, Gg, Ss, Gll, Gll, Ss, Hh, Ss, Sm, Gg, Gg, Sm, Gll, Ss, Ss, Gg, Sm, Ss, Hh, Gg, Ds, Ww, Wo, Wo, Wo, Wo, Wo, Wo, Wo, Wo, Wo, Wo, Wo, Wo, Wo, Wo, Wo, Wo, Wo, Wo, Wo
Gll^Fp, Gll^Fp, Gll^Fp, Gll^Fp, Gll^Fp, Gll^Fp, Ds, Ss, Gg, Gg, Gll^Fp, Gll^Fp, Gg, Gll^Fp, Ss, Gg, Gg, Sm, Ss, Ss, Gll, Ds, Ss, Gll^Fp, Gg, Gg, Gll^Fp, Ss, Gg, Gg, Gg, Ss, Gg, Ss, Ss, Ss, Gg, Gll^Fp, Gg, Gg, Gg, Ds, Gg, Gg, Gg, Gg, Gg, Ww, Ww, Wo, Wo, Wo, Wo, Wo, Wo, Wo, Wo, Wo, Wo, Wo, Wo, Wo, Wo, Wo, Wo, Wo, Wo
Gg, Gg, Gll^Fp, Gll^Fp, Gll^Fp, Gg, Ss, Gg, Ss, Sm, Gg, Hh, Gg, Gll^Fp, Gll^Fp, Hh, Gll^Fp, Ds, Re^Vct, Gll^Fp, Gll^Fp, Ss, Ds, Gg, Sm, Re^Vct, Ss, Gll^Fp, Gll^Fp, Ss, Ss, Gg, Gll^Fp, Gg, Ds, Gg, Ss, Sm, Gg, Gll^Fp, Gg, Ss, Gg, Gs^Vc, Gg, Gg, Gg, Ds, Ds, Ww, Wo, Wo, Wo, Wo, Wo, Wo, Wo, Wo, Wo, Wo, Wo, Wo, Wo, Wo, Wo, Wo, Wo
Gg, Ds, Gs^Vc, Gll^Fp, Ss, Gg, Gg, Gg, Gll^Fp, Re^Vct, Gll^Fp, Gg, Re^Vct, Gll^Fp, Gg, Gll^Fp, Gg, Hh, Ce, Ce, Ce, Hh, Gg, Ds, Gll^Fp, Ss, Ss, Gg, Ss, Hh, Gll^Fp, Gll^Fp, Gg, Ds, Ss, Gll, Gg, Gg, Gg, Hh, Gg, Gg, Gg, Gg, Gg^Eff, Gg, Gg, Gg, Ds, Ww, Wo, Wo, Wo, Wo, Wo, Wo, Wo, Wo, Wo, Wo, Wo, Wo, Wo, Wo, Wo, Wo, Wo
Gg, Gll^Fp, Hh, Gg, Ss, Gll^Fp, Re^Vct, Ds, Sm, Gll^Fp, Gg, Gg, Ce, Ss, Gg, Gll^Fp, Gg, Gll^Fp, Ce, Ce, 3 Ke, Ce, Ce, Gg, Re^Vct, Ss, Hh, Gg, Ss, Gll, Gg, Hh, Ss, Gg, Ss, Gg, Ss, Gll^Fp, Gg, Gg, Gg, Gg, Gg^Eff, Gg^Eff, Gg^Gvs, Gg^Eff, Gg^Eff, Gg, Gg, Ww, Ww, Wo, Wo, Wo, Wo, Wo, Wo, Wo, Wo, Wo, Wo, Wo, Wo, Wo, Wo, Wo, Wo
Gll^Fp, Ss, Gg, Sm, Gll^Fp, Gg, Gll^Fp, Ds, Ss, Gll^Fp, Ce, Ce, Ce, Ce, Gg, Re^Vct, Ss, Hh, Gg, Ce, Ce, Ce, Ce, Gll^Fp, Gg, Ss, Hh, Gll, Gll^Fp, Ds, Gg, Gg, Gg, Gll^Fp, Ss, Ss, Ss, Gg, Gg, Gg, Gg^Eff, Gg^Eff, Gg^Gvs, Gg^Gvs, Gg^Gvs, Gg^Gvs, Gg^Gvs, Gg^Eff, Gg^Eff, Ds, Ds, Ww, Wo, Wo, Wo, Wo, Wo, Wo, Wo, Wo, Wo, Wo, Wo, Wo, Wo, Wo, Wo
Hh, Sm, Sm, Ss, Gll^Fp, Gg, Gg, Gll, Ss, Ce, Ce, 1 Ke, Ce, Ce, Gll^Fp, Gg, Gg, Gg, Ds, Ss, Sm, Ce, Gll, Ss, Ds, Gg, Re^Vct, Ss, Hh, Gll, Ss, Hh, Ss, Gg, Ds, Gg, Gg, Gg, Gg^Eff, Gg^Eff, Gg^Gvs, Gg^Gvs, Gg^Gvs, Gg^Gvs, Gg^Gvs, Gg^Gvs, Gg^Gvs, Gg^Gvs, Gg^Eff, Gg^Eff, Ds, Ww, Wo, Wo, Wo, Wo, Wo, Wo, Wo, Wo, Wo, Wo, Wo, Wo, Wo, Wo, Wo
Ss, Gg, Hh, Gg, Gg, Gg, Gll^Fp, Gg, Ss, Ce, Ce, Ce, Ss, Gg, Ss, Gg, Gll^Fp, Hh, Gll, Ss, Ds, Ss, Hh, Re^Vct, Gll^Fp, Hh, Ss, Gg, Ss, Ss, Gg, Gg, Gg, Ds, Ss, Gg, Gg, Gg, Gg, Gg^Eff, Gg^Eff, Gg^Gvs, Gg^Gvs, Gg^Gvs, Gg^Gvs, Gg^Gvs, Gg^Eff, Gg^Eff, Gs^Fms, Gs^Fms, Gg, Ww, Ww, Wo, Wo, Wo, Wo, Wo, Wo, Wo, Wo, Wo, Wo, Wo, Wo, Wo, Wo
Gg, Gg, Gg, Gg, Gll^Fp, Gll^Fp, Gll^Fp, Ss, Gll^Fp, Ss, Gll^Fp, Sm, Hh, Gll^Fp, Re^Vct, Gll^Fp, Gll^Fp, Ss, Re^Vct, Ss, Ds, Gll^Fp, Gg, Gll, Gg, Gg, Ss, Gg, Gg, Gg, Gg, Gg, Ss, Ss, Ss, Gg, Gg, Gs^Vc, Gg, Gg, Re, Gg^Eff, Gg^Eff, Gg^Gvs, Gg^Eff, Gg^Eff, Re, Gg, Gs^Fms, Gg, Gs^Fms, Ds, Ds, Ww, Ww, Wo, Wo, Wo, Wo, Wo, Wo, Wo, Wo, Wo, Wo, Wo, Wo
Gg, Gg, Gll^Fp, Gg, Gg, Gll^Fp, Ds, Hh, Gg, Sm, Ds, Ss, Gll^Fp, Gg, Gg, Gg, Gg, Ss, Gg, Ds, Ds, Re^Vct, Gg, Ss, Gll^Fp, Ds, Hh, Ds, Ds, Gg, Gll^Fp, Ss, Ss, Ss, Gll^Fp, Gg, Gg, Gg, Re, Re, Re, Re, Re, Gg^Eff, Re, Re, Re, Re, Re, Gg, Gs^Fms, Gg, Gg, Ds, Ww, Wo, Wo, Wo, Wo, Wo, Wo, Wo, Wo, Wo, Wo, Wo, Wo
Gll^Fp, Gll^Fp, Gll^Fp, Ss, Re^Vct, Gg, Sm, Gll^Fp, Gll^Fp, Re^Vct, Gg, Ss, Gg, Hh, Re^Vct, Ss, Gll^Fp, Gll^Fp, Gll^Fp, Gg, Gg, Hh, Ds, Hh, Gll^Fp, Gg, Ss, Hh, Gll^Fp, Hh, Gll, Ds, Gll, Gg, Gg, Gg, Re, Re, Re, Re, Gg, Re, Re, Re, Re, Re, Gs^Fms, Re, Re, Re, Re, Gs^Fms, Gg, Gs^Fms, Ds, Ww, Ww, Wo, Wo, Wo, Wo, Wo, Wo, Wo, Wo, Wo, Wo
Gll^Fp, Gs^Fms, Re^Vct, Gll^Fp, Gll^Fp, Gll^Fp, Gll^Fp, Hh, Ce, Gg, Ss, Ss, Hh, Ss, Ss, Ss, Gg, Gll^Fp, Ss, Gg, Gg, Gll^Fp, Gll^Fp, Ds, Gg, Gg, Gg, Hh, Gg, Gg, Gg, Gg, Gg, Gg, Hh, Re, Re, Re, Gs^Fms, Gs^Fms, Ce, Gs^Fms, Gs^Fms, Re, Gg, Gg, Gg, Gg, Gs^Fms, Re, Re, Re, Gs^Vc, Gs^Fms, Gs^Fms, Ds, Ds, Ww, Ww, Ww, Ww, Wo, Wo, Wo, Wo, Wo, Wo
Ss, Gll^Fp, Gll, Gll^Fp, Gs^Fms, Gll^Fp, Gll^Fp, Ce, Ce, Ce, Ce, Ds, Gg, Gll^Fp, Ss, Ss, Ss, Ds, Gg, Gg, Gg, Gll^Fp, Gg, Ss, Ss, Gg, Gll^Fp, Gg, Gg, Gll, Ss, Ss, Gg, Ss, Gg, Re, Re, Gg, Gg, Ce, 5 Ket, Ce, Gs^Fms, Gg, Gg, Gs^Fms, Gs^Vc, Gg, Gg, Gs^Fms, Re, Re, Gg, Gg, Gg, Gg, Gg, Ds, Ds, Ds, Ds, Ww, Wo, Wo, Wo, Wo, Wo
Ss, Gll^Fp, Gll^Fp, Gll^Fp, Gll^Fp, Ss, Gll^Fp, Ce, Ce, 2 Ke, Ce, Ce, Gg, Hh, Gg, Re^Vct, Ss, Hh, Gg, Hh, Ss, Gg, Gg, Ds, Gll^Fp, Ss, Gg, Hh, Hh, Gg, Gg, Hh, Gll, Gg, Re, Re, Re, Gs^Fms, Gg, Ce, Ce, Ce, Hh, Gg, Gs^Fms, Gs^Fms, Hh, Gs^Fms, Gg, Gs^Fms, Re, Re, Gs^Fms, Gs^Fms, Gg^Gvs, Gg^Gvs, Gg^Gvs, Gg, Gg, Ds, Ds, Ww, Ww, Wo, Wo, Wo, Wo
Ss, Gll^Fp, Gll^Fp, Gg, Hh^Fds, Ss, Hh^Fds, Gg, Gs^Fds, Ce, Ce, Ce, Gg, Gll^Fp, Gg, Gll^Fp, Gll^Fp, Gll, Hh, Gg, Hh, Gg, Gll, Gg, Hh, Gg, Gg, Gll^Fp, Ds, Ss, Gll, Ss, Gg, Re, Re, Re, Gs^Fms, Gs^Fms, Hh, Gs^Fms, Hh, Hh, Mm, Hh, Mm, Mm, Mm, Hh, Hh, Gg, Re, Re, Gs^Fms, Gg^Gvs, Gg^Gvs, Gg^Gvs, Gg^Gvs, Gg^Gvs, Gs^Fms, Ds, Ds, Ds, Ww, Wo, Wo, Wo, Wo
Gg, Gll^Fp, Gg, Gg, Gg, Re^Vct, Gll^Fp, Gll^Fp, Gg, Gll^Fp, Ss, Gg, Gll^Fp, Gg, Re^Vct, Ds, Gll^Fp, Gg, Gll^Fp, Ss, Gll^Fp, Gll^Fp, Gg, Ss, Gg, Gg, Gg, Hh, Gll, Gg, Gg, Gg, Hh, Re, Re, Gs^Fms, Hh, Hh, Mm, Hh, Mm, Mm, Mm, Mm, Mm^Xm, Mm, Mm, Mm, Mm, Hh, Re, Re, Gg, Gg, Gs^Fms, Gg^Gvs, Gg, Gg, Gg, Gs^Fms, Ds, Ds, Ww, Wo, Wo, Wo, Wo
Gg, Hh^Fds, Gll^Fp, Gs^Fds, Gg, Gg, Gg, Ss, Gll^Fp, Gg, Ss, Gg, Gg, Ss, Gg, Gll^Fp, Gg, Gg, Ss, Gll^Fp, Sm, Ds, Gg, Ss, Gg, Ss, Ss, Gll^Fp, Ds, Ss, Gg, Gg, Ds, Re, Re, Hh, Mm, Mm, Mm, Mm, Mm^Xm, Mm, Mm^Xm, Mm^Xm, Xu, Mm^Xm, Mm^Xm, Mm, Mm, Hh, Re, Re, Gs^Fms, Gg, Gs^Vc, Gs^Fms, Gg, Gs^Fms, Ce, Ce, Ce, Ds, Ds, Ww, Wo, Wo, Wo
Gg, Gg, Gll^Fp, Gll^Fp, Gll^Fp, Gll^Fp, Hh^Fds, Gg, Gs^Fms, Gg, Gg, Gg, Gll^Fp, Gll^Fp, Gll^Fp, Gll^Fp, Gg, Gg, Gll^Fp, Ds, Ss, Gg, Ss, Hh, Gll^Fp, Hh, Gg, Ss, Gg, Gg, Ds, Ds, Re, Re, Hh, Mm, Mm, Mm, Mm^Xm, Mm^Xm, Xu, Mm^Xm, Xu, Xu, Cud, Xu, Xu, Mm^Xm, Mm, Hh, Re, Re, Gs^Fms, Gs^Fms, Hh, Gs^Fms, Gg, Gs^Fms, Ce, 6 Ket, Ce, Ds, Ds, Ww, Wo, Wo, Wo
Hh^Fds, Gll^Fp, Hh^Fds, Gll^Fp, Gg, Gg, Gll^Fp, Ss, Gll^Fp, Re^Vct, Hh^Fp, Gg, Gg, Gll^Fp, Gll, Gg, Ss, Gg, Gg, Ss, Ss, Gg, Gg, Gg, Gg, Gg, Hh, Gg, Ce, Ce, Re, Re, Hh, Hh, Mm, Mm, Mm^Xm, Mm^Xm, Xu, Xu, Cud, Xu, Cud, Cud, Rr^Vhc, Cud, Xu, Mm^Xm, Re, Re, Re, Re, Hh, Hh, Mm, Hh, Hh, Gg, Gg, Ce, Gs^Fms, Ds, Ds, Ww, Wo, Wo, Wo
Gll^Fp, Gs^Vc, Gs^Fds, Gll^Fp, Gg, Gg, Gg, Gs^Fds, Gs^Fds, Gll^Fp, Gg, Gll^Fp, Gg, Gll, Hh^Fp, Gs^Fds, Gg, Ds, Gll^Fp, Gg, Ss, Gg, Ss, Hh, Ss, Gg, Hh, Gll, Ce, Ce, Re, Re, Hh, Mm, Mm, Mm^Xm, Xu, Xu, Cud, Cud, Rr, Cud, Rr, Rr, Rr, Rr, Rr, Re, Re, Re, Mm, Mm, Mm, Mm, Mm, Mm, Hh, Hh, Hh, Gs^Fms, Ds, Ds, Ds, Ww, Wo, Wo, Wo
Gg, Gll^Fp, Gll^Fp, Ss, Ss, Gll^Fp, Gll^Fp, Gg, Gg, Gll^Fp, Gg, Gg, Gg, Gg, Gll^Fp, Gg, Ss, Hh, Ss, Gg, Gll^Fp, Gg, Gll^Fp, Gg, Gll^Fp, Gg, Gg, Gg, Re, Re, Re, Re, Re, Mm, Mm^Xm, Mm^Xm, Xu, Cud, Rr, Rr^Vhc, Rr, Rr, Ww, Ww, Ww, Rr, Rr, Rr, Xu, Mm^Xm, Mm^Xm, Mm^Xm, Mm^Xm, Mm^Xm, Mm^Xm, Mm, Mm, Hh, Mm, Hh, Hh, Ds, Ds, Ww, Wo, Wo, Wo
Gll^Fp, Gs^Fds, Gg, Gll^Fp, Gg, Gg, Gs^Fds, Gg, Gll^Fp, Ss, Gs^Fds, Gg, Gll^Fp, Gll^Fp, Gg, Hh^Fds, Gg, Ss, Gll^Fp, Hh, Ss, Ss, Gg, Gg, Ds, Ds, Re, Re, Re, Re, Hh, Re, Re, Re, Re, Xu, Cud, Cud, Rr, Rr, Ww, Ww, Rr^Vhc, Rr, Cmy, Ww, Ww, Rr, Cud, Xu, Xu, Xu, Xu, Xu, Xu, Mm^Xm, Mm^Xm, Mm, Mm, Mm, Mm, Hd, Ds, Ww, Wo, Wo, Wo
Gll^Fp, Gll^Fp, Gs^Fds, Gs^Fds, Hh^Fp, Ss, Hh^Fds, Ss, Gll^Fp, Gs^Fds, Ss, Gll^Fp, Gll^Fp, Gg, Gg, Gg, Hh^Fp, Ss, Gg, Gg, Ds, Gll^Fp, Gs^Vc, Gg, Re, Re, Re, Re, Hh, Hh, Mm, Mm, Mm^Xm, Re, Rr, Rr, Rr, Rr, Ww, Ww, Rr, Cmy, Rr, Rr, Rr, Cmy, Ww, Rr, Rr, Cud, Cud, Cud, Cud, Cud, Cud, Xu, Xu, Mm^Xm, Mm^Xm, Mm, Mm, Hd, Hd, Ww, Wo, Wo, Wo
Gll^Fp, Ss, Gg, Gll^Fp, Gg, Gll^Fp, Gll^Fp, Gg, Hh^Fds, Gll^Fp, Gg, Gll, Gll^Fp, Gg, Gll^Fp, Gll^Fp, Gll^Fp, Ss, Gg, Gg, Gg, Gg, Gg, Re, Re, Re, Gs^Fms, Hh, Mm, Mm, Mm^Xm, Mm^Xm, Xu, Xu, Rr, Rr, Rr, Ww, Cmy, Rr, Rr, Rr, Ww, Ww^Bsb|, Ww, Rr, Rr, Ww^Bsb/, Ww, Rr, Rr, Rr^Vhc, Rr, Rr, Rr, Cud, Cud, Xu, Mm^Xm, Mm, Mm, Hd, Hd, Ww, Wo, Wo, Wo
Gll^Fp, Gll^Fp, Gll^Fp, Gll^Fp, Gll^Fp, Gg, Gs^Fds, Gll^Fp, Gll^Fp, Gll^Fp, Gll^Fp, Gg, Ss, Hh^Fp, Gg, Gg, Gg, Gs^Fds, Hh^Fds, Gg, Gg, Gg, Re, Re, Re, Gs^Fms, Gg, Hh, Mm, Mm, Mm^Xm, Xu, Cud, Cud, Rr, Rr^Vhc, Rr, Ww, Rr, Rr, Ww, Ww, Ww, Ww^Bsb|, Ww, Ww, Rr, Cmy, Rr, Ww, Ww, Rr, Rr, Rr, Rr^Vhc, Rr, Cud, Xu, Mm^Xm, Mm, Mm, Hd, Ds, Ww, Wo, Wo, Wo
Gg, Gs^Fds, Ss, Gs^Vc, Ss, Gll^Fp, Gg, Gg, Gs^Fds, Gll^Fp, Gll^Fp, Hh^Fp, Gg, Ss, Gg, Gll^Fp, Gg, Gll^Fp, Gg, Gg, Re, Re, Re, Re, Gg, Gs^Fms, Gg, Hh, Mm, Mm, Mm^Xm, Xu, Cud, Rr, Rr, Rr, Ww, Ww^Bsb\, Rr, Ww, Ww, Ww, Rr, Rr, Ww, Ww, Ww, Rr, Rr^Vhc, Cmy, Ww, Rr, Rr, Rr, Rr, Rr, Cud, Xu, Mm^Xm, Mm, Hd, Hd, Ww, Ww, Wo, Wo, Wo
Gll^Fp, Gs^Fds, Ss, Ss, Gs^Fms, Ss, Gll^Fp, Gll^Fp, Gg, Ss, Gg, Gll^Fp, Gg, Gg, Gg, Gg, Gg, Gg, Re, Re, Re, Re, Gs^Fms, Gs^Fms, Gs^Fms, Gg, Gs^Fms, Hh, Mm, Mm, Mm^Xm, Xu, Cud, Rr^Vhc, Rr, Ww, Cmy, Rr, Rr, Ww, Ww, Rr, Cmy, Cmy, Cmy, Ww, Ww, Rr, Rr, Cmy, Ww, Rr, Rr, Rr^Vhc, Rr, Rr, Cud, Xu, Mm^Xm, Mm, Hd, Hd, Ww, Wo, Wo, Wo, Wo
Hh^Fp, Gg, Gll^Fp, Gg, Gll^Fp, Ss, Gll^Fp, Hh^Fds, Hh^Fds, Hh^Fds, Gg, Gs^Vc, Gg, Gg, Gg, Gg, Gg, Gs^Vc, Re, Re, Gg, Gg, Gg^Gvs, Gg^Gvs, Gg^Gvs, Gg, Gg, Gs^Fms, Hh, Mm, Mm^Xm, Xu, Cud, Rr, Rr, Ww, Cmy, Rr, Rr, Ww, Ww^Bsb/, Rr, Cmy, 4 Kmy, Cmy, Ww, Ww, Ww, Rr, Ww, Rr, Rr, Rr, Rr, Rr, Rr, Xu, Xu, Mm^Xm, Mm, Hd, Ww, Wo, Wo, Wo, Wo, Wo
Gg, Gll^Fp, Gll^Fp, Gs^Fds, Gll^Fp, Gll^Fp, Hh^Fds, Gll^Fp, Gll^Fp, Gg, Gg, Gg, Gg^Eff, Gg^Eff, Gg^Eff, Gg, Gg, Gg, Re, Re, Gg, Gg^Gvs, Gg^Gvs, Gg^Gvs, Gg^Gvs, Gg^Gvs, Gg, Gs^Fms, Hh, Mm, Mm^Xm, Xu, Xu, Cud, Rr, Ww, Cmy, Rr^Vhc, Rr, Ww^Bsb/, Ww, Ww, Ww, Cmy, Rr, Rr, Ww^Bsb\, Ww, Rr, Ww^Bsb\, Rr, Rr^Vhc, Cud, Cud, Re, Re, Re, Mm^Xm, Mm, Hd, Ds, Ww, Wo, Wo, Wo, Wo, Wo
Gs^Fds, Gll^Fp, Hh^Fds, Gg, Gll^Fp, Hh^Fds, Gg, Gs^Fds, Gll^Fp, Gg, Gg^Eff, Gg^Eff, Gg^Gvs, Gg^Gvs, Gg^Gvs, Gg^Eff, Gg^Eff, Gg, Re, Re, Gg, Gs^Fms, Gs^Fms, Gg^Gvs, Gg, Gg, Gg, Hh, Mm, Mm, Mm^Xm, Mm^Xm, Xu, Cud, Rr, Ww, Ww, Rr, Rr, Rr, Rr, Ww, Ww, Rr, Ww, Ww, Ww, Ww^Bsb\, Rr, Ww, Rr, Cud, Xu, Xu, Mm^Xm, Re, Re, Re, Hd, Hd, Ww, Ww, Wo, Wo, Wo, Wo, Wo
Gg, Gll^Fp, Gs^Fds, Gg, Gll^Fp, Ss, Gll^Fp, Gll^Fp, Gg^Eff, Gg^Eff, Gg^Gvs, Gg^Gvs, Gg^Gvs, Gg^Gvs, Gg^Gvs, Gg^Gvs, Gg^Eff, Gg^Eff, Re, Re, Re, Gg, Gs^Fms, Gg, Gs^Fms, Gs^Fms, Gg, Hh, Mm, Mm, Mm, Mm^Xm, Xu, Cud, Cud, Rr, Rr, Ww, Ww, Rr^Vhc, Rr, Ww, Ww, Ww, Ww, Ww, Rr, Rr, Ww, Ww, Rr, Cud, Xu, Mm^Xm, Mm, Mm, Re, Re, Ds, Ds, Ww, Wo, Wo, Wo, Wo, Wo, Wo
Gg, Gs^Vc, Gll^Fp, Gll^Fp, Hh^Fp, Hh^Fds, Gg, Gll^Fp, Gll^Fp, Gg^Eff, Gg^Eff, Gg^Gvs, Gg^Gvs, Gg^Gvs, Gg^Eff, Gg^Eff, Gg, Gg, Gg, Re, Re, Re, Re, Gg, Gs^Fms, Gg, Gs^Fms, Gg, Hh, Mm, Mm, Mm^Xm, Mm^Xm, Xu, Cud, Rr^Vhc, Rr, Rr, Ww, Rr, Cmy, Rr, Rr, Ww, Rr, Rr, Rr^Vhc, Cmy, Ww, Rr, Cud, Cud, Xu, Mm^Xm, Mm, Hh, Re, Re, Ww, Ww, Wo, Wo, Wo, Wo, Wo, Wo, Wo
Gll^Fp, Gg, Gll^Fp, Gs^Fms, Gg, Gg, Ss, Ss, Gg, Ss, Gs^Fds, Gg^Eff, Gg^Eff, Gg^Eff, Gg, Gg, Ce, Gg, Gg, Gg, Gg, Re, Re, Gg, Gg, Gg, Gg, Gs^Fms, Hh, Mm, Mm, Mm, Mm^Xm, Xu, Xu, Cud, Cud, Rr, Rr, Ww, Ww, Ww, Ww, Rr, Ww, Cmy, Ww, Ww, Rr, Rr, Cud, Xu, Mm^Xm, Mm^Xm, Mm, Hh, Re, Ds, Ww, Wo, Wo, Wo, Wo, Wo, Wo, Wo, Wo
Gll^Fp, Gll^Fp, Gll^Fp, Hh^Fp, Hh^Fds, Gg, Gg, Gg, Ss, Gg, Gll^Fp, Gg, Gg, Gg, Gg, Ce, 8 Ket, Ce, Gg, Gs^Vc, Gg, Re, Re, Gs^Fms, Gg, Gs^Fms, Gg, Gs^Fms, Gg, Hh, Hh, Mm, Mm, Mm^Xm, Mm^Xm, Xu, Xu, Cud, Cud, Rr, Rr, Rr, Rr, Ww^Bsb|, Rr, Ww, Rr, Rr, Rr, Rr, Cud, Xu, Mm^Xm, Mm, Hh, Re, Ds, Ww, Wo, Wo, Wo, Wo, Wo, Wo, Wo, Wo, Wo
Gg, Gll^Fp, Gs^Fds, Gg, Gg, Gg, Gs^Vc, Gg, Gg, Ss, Gg, Gs^Fms, Gg, Gs^Vc, Gg, Ce, Ce, Ce, Wwf, Gg, Gg, Re, Re, Gs^Fms, Gg, Gs^Fms, Gs^Fms, Gg, Gs^Fms, Gs^Fms, Gs^Fms, Mm, Mm, Mm, Mm, Mm^Xm, Mm^Xm, Xu, Xu, Cud, Cud, Cud, Cud, Rr, Rr, Rr, Rr^Vhc, Rr, Cud, Cud, Xu, Xu, Mm^Xm, Mm, Hh, Re, Ds, Ww, Wo, Wo, Wo, Wo, Wo, Wo, Wo, Wo, Wo
Gs^Fms, Gg, Gs^Fms, Gll^Fp, Gll^Fp, Gs^Fds, Gll^Fp, Gll^Fp, Gll^Fp, Gll^Fp, Gg, Ss, Gll^Fp, Gg, Gg, Gg, Wwf, Wwf, Ww, Wwf, Gg, Re, Re, Re, Re, Gg, Gg, Gg, Gg^Gvs, Gg, Gg, Hh, Hh, Mm, Mm, Mm, Mm, Mm^Xm, Mm^Xm, Xu, Xu, Xu, Xu, Cud, Cud, Rr, Rr, Cud, Xu, Xu, Mm^Xm, Mm^Xm, Mm, Mm, Hh, Re, Ds, Ww, Wo, Wo, Wo, Wo, Wo, Wo, Wo, Wo, Wo
Gll^Fp, Gg, Gg, Gg, Gs^Fds, Hh^Fds, Gll^Fp, Gg, Gll^Fp, Ss, Ss, Gg, Gg, Gs^Fms, Gll, Gg, Wwf, Ww, Ww, Wwf, Wwf, Gg, Gg, Re, Re, Gs^Fms, Gg^Gvs, Gg^Gvs, Gg^Gvs, Gg^Gvs, Gg^Gvs, Gg, Gg, Hh, Hh, Hh, Hh, Mm, Mm, Mm^Xm, Mm^Xm, Mm^Xm, Mm^Xm, Xu, Xu, Re, Re, Cud, Xu, Mm^Xm, Mm, Mm, Mm, Mm, Hh, Re, Re, Ww, Ww, Wo, Wo, Wo, Wo, Wo, Wo, Wo, Wo
Gll^Fp, Gg, Gs^Fms, Gg, Gg, Gll^Fp, Gll^Fp, Gg, Hh^Fp, Ss, Ss, Gll^Fp, Gg, Ss, Gg, Gg, Gg, Wwf, Ww, Ww, Ww, Wwf, Gg, Re, Re, Gs^Fms, Gs^Fms, Gg^Gvs, Gg^Gvs, Gg^Gvs, Gg^Gvs, Gg^Gvs, Gg, Gs^Fms, Gs^Fms, Gs^Fms, Hh, Mm, Mm, Mm, Mm, Mm, Mm, Mm^Xm, Gs^Fms, Re, Re, Xu, Mm^Xm, Mm^Xm, Mm, Mm, Mm, Hh, Gs^Fms, Re, Re, Ds, Ww, Wo, Wo, Wo, Wo, Wo, Wo, Wo, Wo
Gll^Fp, Hh^Fp, Gg, Ss, Gll^Fp, Ss, Gg, Gg, Ss, Hh^Fds, Gg, Ss, Gll^Fp, Gg, Ss, Gll^Fp, Gg, Wwf, Wwf, Ww, Ww, Wwf, Gg, Re, Re, Re, Re, Gg, Gg, Gg^Gvs, Gg, Gg, Gg, Gg, Gg, Gg, Gg, Hh, Hh, Mm, Mm, Mm, Hh, Hh, Gs^Fms, Re, Re, Gs^Fms, Hh, Mm, Hh, Mm, Hh, Hh, Gs^Fms, Re, Re, Ce, Ds, Ww, Ww, Wo, Wo, Wo, Wo, Wo, Wo
Gll^Fp, Gll^Fp, Gll^Fp, Gll^Fp, Hh^Fds, Gll^Fp, Gg, Gll^Fp, Gll^Fp, Gll^Fp, Gg, Gg, Gg, Gll^Fp, Gll^Fp, Gs^Fms, Gll^Fp, Gg, Gg, Wwf, Wwf, Wwf, Wwf, Gg, Gg, Re, Re, Re, Re, Gg, Re, Gs^Fms, Gs^Fms, Gs^Fms, Gg, Gs^Fms, Gg, Gs^Fms, Gs^Fms, Hh, Gg, Hh, Gg, Gs^Fms, Ce, Re, Re, Ce, Ce, Hh, Gg, Hh, Gg, Gs^Fms, Gg, Re, Re, Ce, Gg, Ds, Ww, Wo, Wo, Wo, Wo, Wo, Wo
Gll^Fp, Gg, Gll^Fp, Gg, Gg, Hh^Fp, Gg, Gs^Fms, Gll^Fp, Gg, Gg, Gg, Ss, Gll, Gll^Fp, Gg, Gg, Gll^Fp, Gg, Gg, Wwf, Wwf, Ce, Ce, Ce, Gg, Gg, Re, Re, Re, Re, Re, Re, Re, Re, Gs^Fms, Gs^Fms, Gg, Gs^Fms, Gg, Gs^Fms, Gg, Gs^Fms, Ce, Re, Re, Re, Gs^Fms, Gs^Fms, Gs^Fms, Re, Gs^Fms, Gs^Fms, Gg, Re, Re, Re, Gg, Gg, Gg, Ds, Ww, Ww, Wo, Wo, Wo, Wo
Gg, Gg, Gs^Fms, Gll^Fp, Gs^Fds, Hh^Fp, Gll^Fp, Gg, Gg, Hh^Fds, Gs^Fds, Ss, Gg, Gg, Ss, Gg, Ss, Gg, Gg, Gg, Gg, Wwf, Ce, 9 Ket, Ce, Gg, Gg, Gg, Gg, Re, Gg^Eff, Re, Re, Re, Re, Re, Re, Re, Re, Gg, Gg, Gs^Fms, Re, Re, Re, Re, Re, Re, Re, Re, Re, Re, Re, Re, Re, Re, Gg, Gg, Gs^Vc, Gg, Gg, Ds, Ww, Wo, Wo, Wo, Wo
Gg, Gll^Fp, Gg, Gg, Gs^Vc, Gs^Fms, Gg, Gll^Fp, Gs^Fms, Gll^Fp, Gll^Fp, Gll, Gs^Fds, Gll^Fp, Gg, Gg, Gg, Gg, Gs^Fms, Gs^Fms, Gg, Gg, Gg, Ce, Gg, Gg, Gg, Gg, Gg^Eff, Gg^Eff, Gg^Gvs, Gg^Eff, Gg^Eff, Gg, Gg, Re, Re, Re, Re, Re, Re, Re, Re, Re, Gg, Re, Re, Re, Re, Re, Gg, Re, Re, Re, Gg, Gg, Gg, Gg, Gg, Gg, Gg, Ds, Ww, Wo, Wo, Wo, Wo
Hh^Fds, Ss, Gll^Fp, Gg, Gg, Hh^Fds, Gll, Gg, Gg, Gg, Gll^Fp, Ss, Gll^Fp, Hh^Fp, Gs^Vc, Gg, Gs^Fms, Hh^Fds, Hh^Fds, Gg, Gg, Gg, Gg, Gg, Gg, Gg, Gg^Eff, Gg^Eff, Gg^Gvs, Gg^Gvs, Gg^Gvs, Gg^Gvs, Gg^Gvs, Gg^Eff, Hh^Eff, Gg, Hhd, Hhd, Hh, Re, Re, Re, Gg, Gg, Gg, Re, Re, Gg, Gg, Gg, Ce, Ce, Ce, Gg, Gg, Gg, Gg, Gg, Gll^Fp, Gll, Gg, Gg, Hh^Fp, Ww, Ww, Wo, Ww
Gs^Fds, Gg, Gll^Fp, Gg, Gll^Fp, Ss, Gg, Hh^Fds, Gs^Fds, Gll^Fp, Hh^Fp, Gg, Gs^Fms, Gg, Gg, Gs^Fds, Gll, Ss, Gg, Gs^Fds, Gg, Hh^Fp, Gg, Gg, Gg^Eff, Gg^Eff, Gg^Gvs, Gg^Gvs, Gg^Gvs, Gg^Gvs, Gg^Gvs, Gg^Gvs, Gg^Gvs, Gg^Gvs, Hh^Eff, Hh^Eff, Mm, Mm, Mm, Hh, Gg, Gg, Gg, Gs^Vc, Gg, Re, Re, Gg, Gg, Gg, Ce, 7 Ket, Ce, Gg, Gll^Fp, Gg, Gg, Gll^Fp, Gll^Fp, Gg, Gll^Fp, Gll, Gg, Gg, Gg, Ww, Ss
Gg, Gs^Fds, Ss, Ss, Hh^Fp, Gll^Fp, Gs^Fds, Hh^Fds, Gg, Gll^Fp, Gg, Hh^Fp, Gll^Fp, Ss, Gll^Fp, Gs^Fms, Ss, Ss, Hh^Fds, Gg, Gg, Gs^Fms, Hh^Fp, Gg^Eff, Gg^Eff, Gg^Gvs, Gg^Gvs, Gg^Gvs, Gg^Gvs, Gg^Gvs, Gg^Gvs, Gg^Gvs, Gg^Eff, Hh^Eff, Mm, Mm, Mm, Mm, Hhd, Hh, Gg, Gg, Gll, Gg, Gg, Re, Gll^Fp, Gll, Ss, Gg, Gll, Ce, Gg, Gg, Gs^Fms, Gg, Gg, Gg, Gll, Gll^Fp, Gll^Fp, Gg, Ss, Hh^Fp, Hh^Fp, Hh^Fp, Ss
Gs^Fds, Gs^Fds, Gg, Gg, Gg, Gll^Fp, Gg, Gs^Fds, Gll^Fp, Gll^Fp, Gll^Fp, Gg, Gg, Gg, Gg, Gg, Gll^Fp, Gg, Ss, Gll^Fp, Gll^Fp, Gg, Ss, Ss, Gll^Fp, Gg^Eff, Gg^Eff, Gg^Gvs, Gg^Gvs, Gg^Gvs, Gg^Eff, Gg^Eff, Gg, Hhd, Hhd, Mm, Hh, Hh, Gs^Fms, Gg, Gs^Fds, Gs^Fms, Ss, Hh^Fds, Gg, Re, Gg, Gg, Gll^Fp, Gg, Ss, Gll, Ss, Gll^Fp, Gg, Gll^Fp, Gg, Gg, Gg, Gg, Gg, Gg, Ss, Gs^Fms, Gg, Gg, Gg
Gll^Fp, Ss, Gg, Gll^Fp, Hh^Fds, Ss, Gll^Fp, Gs^Fms, Gll^Fp, Gg, Gg, Gll^Fp, Gll^Fp, Gg, Gs^Fds, Gs^Fms, Gs^Fds, Gs^Fds, Gll^Fp, Gg, Gg, Gg, Gs^Fds, Gs^Fms, Gg, Gg, Gg, Gg^Eff, Gg^Eff, Gg^Eff, Gg, Gg, Gg, Gg, Gg, Hh, Ss, Gll^Fp, Gs^Fds, Gg, Gg, Gs^Fms, Gg, Gg, Gll^Fp, Re, Re, Hh^Fp, Gll^Fp, Gll^Fp, Gg, Gg, Ss, Gg, Gs^Fms, Gg, Gg, Ss, Gs^Fds, Gg, Gs^Fms, Hh^Fp, Hh^Fp, Ss, Gg, Gg, Gll^Fp
Gg, Gll^Fp, Gg, Gg, Gll^Fp, Gs^Fds, Ss, Gg, Gll^Fp, Hh^Fds, Gg, Gll^Fp, Gll^Fp, Gs^Fds, Hh^Fp, Gll^Fp, Gll^Fp, Gg, Gs^Fds, Gg, Gg, Hh^Fds, Gg, Gg, Gll^Fp, Gg, Gs^Fds, Hh^Fds, Gll^Fp, Ss, Hh^Fp, Gs^Fms, Ss, Gs^Vc, Gs^Fms, Gll^Fp, Gg, Gll^Fp, Gll^Fp, Ss, Gg, Ss, Gg, Gll^Fp, Gg, Re, Re, Re, Re, Ss, Gll^Fp, Ss, Gll^Fp, Ss, Gll, Gll, Gg, Gg, Gll^Fp, Gll^Fp, Hh^Fds, Gg, Gg, Gg, Ds, Ss, Gll^Fp
Gg, Gg, Hh^Fp, Gs^Fds, Ss, Gll^Fp, Gll^Fp, Gg, Ss, Gll^Fp, Gll^Fp, Gll^Fp, Gll^Fp, Ss, Gll^Fp, Gll^Fp, Gg, Gg, Gll^Fp, Gs^Fms, Ss, Gg, Gll^Fp, Hh^Fp, Gg, Ss, Gg, Gll^Fp, Hh^Fp, Ss, Gg, Gll^Fp, Gg, Gs^Fms, Gg, Gg, Gll^Fp, Gg, Gg, Gg, Gg, Gll^Fp, Gll^Fp, Gg, Gg, Ss, Gg, Re, Re, Re, Re, Gll^Fp, Gg, Ss, Gg, Gs^Fms, Gg, Gs^Vc, Gg, Gll^Fp, Gs^Fms, Gll^Fp, Gs^Fds, Ss, Gll, Gll^Fp, Gg
Gg, Gs^Fds, Gg, Gll^Fp, Ss, Ss, Gll^Fp, Ss, Hh^Fds, Gs^Fms, Gg, Gg, Gs^Vc, Ss, Gg, Gll^Fp, Hh^Fds, Ss, Gll^Fp, Gg, Gs^Vc, Gg, Gs^Fms, Gg, Gll^Fp, Gg, Gs^Fms, Gg, Ss, Gs^Fms, Hh^Fp, Ss, Hh^Fp, Gg, Gll, Gll^Fp, Gll^Fp, Gg, Gg, Gg, Ss, Gg, Gll, Gs^Vc, Ds, Hh^Fds, Gs^Fds, Ss, Gll^Fp, Re, Re, Gg, Gll, Gll^Fp, Ss, Gg, Gll^Fp, Ds, Gg, Ss, Gll^Fp, Gll^Fp, Hh^Fds, Gll^Fp, Gg, Gll^Fp, Gs^Fms
Gg, Gg, Gs^Fds, Hh^Fp, Gll^Fp, Hh^Fds, Gg, Gg, Gg, Ss, Gs^Fds, Gg, Gg, Gs^Fds, Ss, Gg, Gll^Fp, Gll^Fp, Gll^Fp, Hh^Fp, Gg, Gg, Hh^Fp, Ss, Gg, Gs^Fds, Ss, Gll^Fp, Gg, Gg, Ss, Gg, Gs^Fms, Ds, Gg, Gs^Fms, Ss, Gs^Fds, Gll^Fp, Hh^Fp, Gll^Fp, Gg, Gll^Fp, Gll, Gs^Fds, Gg, Gll^Fp, Gll^Fp, Gg, Re, Re, Ss, Gg, Gg, Gll^Fp, Gll^Fp, Gg, Gll, Gg, Gg, Gll^Fp, Ds, Gll^Fp, Ss, Gll^Fp, Gg, Gg
Gs^Fds, Gll^Fp, Gll^Fp, Gg, Gg, Gll^Fp, Ss, Gg, Gs^Fds, Gs^Fds, Gll^Fp, Hh^Fds, Hh^Fds, Gs^Fms, Gs^Fds, Gll^Fp, Gll^Fp, Gll^Fp, Gll^Fp, Gll^Fp, Gs^Fms, Gs^Fms, Ss, Gg, Gs^Fds, Ss, Hh^Fds, Gg, Ss, Gg, Gg, Gs^Vc, Gg, Gg, Gg, Gll^Fp, Gg, Gll^Fp, Gg, Gll^Fp, Gll^Fp, Gg, Ss, Gg, Ss, Gll, Gg, Gg, Gg, Re, Re, Gll, Gs^Fds, Gg, Gll^Fp, Ss, Gg, Ss, Ss, Gll^Fp, Gll^Fp, Gll^Fp, Gll^Fp, Ss, Gg, Gg, Gg
Gll^Fp, Gll^Fp, Gg, Gg, Gll^Fp, Gll^Fp, Hh^Fp, Gll^Fp, Ss, Gll^Fp, Gll^Fp, Gll, Hh^Fp, Gs^Fds, Ss, Gll, Hh^Fp, Gg, Gll, Gg, Ss, Hh^Fp, Gg, Gll^Fp, Gll^Fp, Gll^Fp, Gs^Fds, Ss, Gg, Hh^Fp, Ss, Gll^Fp, Gs^Fds, Ss, Gll^Fp, Hh^Fp, Gg, Hh^Fds, Gs^Vc, Gll^Fp, Gg, Gll^Fp, Gg, Ss, Gg, Hh^Fp, Gg, Gg, Gll^Fp, Re, Re, Gs^Fms, Ds, Gg, Ss, Gg, Hh^Fp, Gll, Gg, Gll^Fp, Gs^Fds, Ss, Hh^Fp, Gll^Fp, Gg, Ss, Gll
Gll^Fp, Gll^Fp, Gg, Gll^Fp, Hh^Fds, Gg, Gg, Gg, Gg, Gg, Gg, Gll^Fp, Gs^Fms, Gll^Fp, Hh^Fp, Gg, Gg, Gll^Fp, Gs^Vc, Gg, Gs^Fms, Ss, Ss, Gll^Fp, Gll^Fp, Gg, Gll, Ss, Gg, Gg, Gg, Gll^Fp, Ss, Hh^Fp, Gg, Gg, Gg, Gs^Fms, Ss, Gll, Gll^Fp, Hh^Fds, Gg, Gll^Fp, Gll^Fp, Gll^Fp, Gll^Fp, Gll^Fp, Gll, Re, Re, Gll^Fp, Gll^Fp, Gll^Fp, Ss, Gg, Gll^Fp, Gll, Gll, Gll^Fp, Gg, Gll, Gs^Fds, Ss, Ss, Gll^Fp, Hh^Fp
Gll^Fp, Gg, Gg, Gll^Fp, Ss, Ss, Gg, Gg, Gg, Gg, Gg, Gg, Gg, Hh^Fp, Ss, Gll^Fp, Gll^Fp, Gll^Fp, Gll^Fp, Gll^Fp, Hh^Fp, Gg, Gll^Fp, Gll^Fp, Gll, Gs^Fms, Gg, Gg, Hh^Fp, Gs^Fds, Ss, Gs^Fds, Gs^Fms, Gg, Gg, Gg, Gg, Ss, Ss, Gg, Ss, Gg, Gll^Fp, Gs^Fms, Gs^Fms, Hh^Fp, Gg, Ss, Gs^Vc, Re, Re, Gg, Gg, Gll^Fp, Gg, Hh^Fp, Gg, Gs^Fds, Gll^Fp, Hh^Fp, Gll^Fp, Ss, Gll^Fp, Gs^Fms, Ds, Gg, Gll^Fp
Gs^Fds, Gs^Fms, Hh^Fds, Gll^Fp, Gs^Fms, Gll^Fp, Hh^Fp, Gg, Gll^Fp, Gll, Ss, Gg, Gg, Gg, Gll, Ss, Hh^Fds, Gg, Ss, Gll^Fp, Gs^Fms, Hh^Fds, Gs^Fms, Gll^Fp, Gg, Gs^Vc, Gg, Gll^Fp, Gll, Gg, Gg, Gll^Fp, Hh^Fp, Gg, Hh^Fp, Gll^Fp, Ss, Gll^Fp, Gll^Fp, Gll^Fp, Gg, Gg, Gs^Fms, Gll^Fp, Gs^Fds, Gg, Gs^Fms, Gll, Gll, Re, Re, Gg, Gg, Gll, Gll, Gg, Gg, Gg, Gs^Fms, Gg, Gg, Hh^Fp, Hh^Fp, Gll^Fp, Gll^Fp, Hh^Fp, Gg
Gg, Ds, Gll^Fp, Gg, Gll^Fp, Ss, Gll^Fp, Gll^Fp, Hh^Fds, Hh^Fds, Hh^Fds, Gg, Gg, Gg, Gll^Fp, Gll^Fp, Ss, Gs^Fms, Gll^Fp, Gg, Gll^Fp, Gll^Fp, Gll^Fp, Ss, Gg, Gs^Fms, Gll^Fp, Gll^Fp, Ss, Gg, Gg, Gll, Gg, Gll^Fp, Gll^Fp, Gs^Fms, Gg, Gg, Ss, Gg, Gg, Gg, Gg, Gg, Gg, Gll^Fp, Gg, Gll^Fp, Ss, Re, Re, Gll^Fp, Hh^Fp, Gg, Gll^Fp, Gg, Gg, Gll, Ss, Gll^Fp, Gg, Ss, Gs^Fms, Gg, Gll^Fp, Gg, Ss
