border_size=1
usage=map

Ww          , Ww          , Ww          , Ww          , Ww          , Ww          , Ds          , Ds          , Xu^Uov      , Xu^Uov      , Xu^Uov      , Xu          , Xu^Uov      , Xu          , Xol         , Wwb         , Rp          , Rr          , Wwb         , Wwb         , Xos         , Xos         , Xu          
Ww          , Ww          , Ds          , Ds          , Cvj         , Ds          , Cvj         , Ds          , Xos         , Xu          , Xu^Uov      , Xu^Uov      , Xol         , Xol         , Wwb         , Wwb         , Rp          , 1 Rrc       , Xos         , Xos         , Xu          , Xu          , Xu          
Ww          , Ww          , Rr^Rhx      , Cvj         , Re          , Re          , Rr^Rhx      , Rr^Rhx      , Rr^Rhx      , Xos^Uov     , Xos         , Xol         , Cud         , Rr          , Rr          , Rr          , Wwb         , Wwb         , Xos         , Xu          , Xu          , Xu          , Hh          
Ww          , Ds          , Rr^Rhx      , Re          , Rr^Vhc      , Rr^Rhx      , Rr^Rhx      , Rr^Vhc      , Re          , Rr^Rhx      , Cvj         , Re          , Re          , Cud         , Cud         , Wwb         , Xos         , Xos         , Xu          , Xu          , Xu          , Hh          , Gll^Fmf     
Ds          , Cvj         , Rr^Rhx      , Re          , Rr^Rhx      , 2 Rr^Rhx    , Re          , Re          , Cvj         , Re          , Re          , Re          , Re          , Re          , Re          , Xos         , Xu          , Xu          , Xu          , Xu          , Gll^Fmf     , Gll^Fp      , Re          
Ds          , Cvj         , Cvj         , Re          , Rr^Rhx      , Rr^Vhc      , Re          , Cvj         , Kvj         , Cvj         , Re          , Rr^Vhc      , Re          , Re          , Cvj         , Xos         , Xu          , Xu          , Hh          , Hh          , Gll^Fmf     , Gd^Fdf      , Re          
Ww          , Ds          , Ds          , Re          , Re          , Rr^Rhx      , Re          , Cvj         , Cvj         , Cvj         , Re          , Rr^Rhx      , Re          , Rr^Rhx      , Rr^Rhx      , Xos         , Xos         , Xos         , Hh          , Gll^Fmf     , Re          , Re          , Gll^Fmf     
Ww          , Ww          , Ww          , Cvj         , Cvj         , Re          , Rr^Rhx      , Re          , Re          , Re          , Rr^Rhx      , Re          , Rr^Rhx      , Rr^Rhx      , 3 Rr^Vhc    , Rr^Vhx      , Rr^Rhx      , Cvj         , Re          , Re          , Gll^Fp      , Gll^Fp      , Gll^Fmf     
Wo          , Ww          , Ww          , Ds          , Cvj         , Rr^Rhx      , Rr^Vhx      , 4 Rr^Vhc    , Re          , Rr^Vhc      , Rr^Rhx      , Re          , Re          , Rr^Rhx      , Re          , Rr^Rhx      , Rr^Rhx      , Rr^Rhx      , Re          , Cvj         , Ds          , Ds          , Ww          
Wo          , Ww          , Ww          , Ds          , Rr^Vhc      , Rr^Rhx      , Rr^Rhx      , Rr^Rhx      , Re          , Rr^Rhx      , Cvj         , Rr^Rhx      , Rr^Rhx      , Re          , Rr^Rhx      , Re          , Re          , Re          , Cvj         , Cvj         , Ww          , Ww          , Wwr         
Wo          , Ww          , Ww          , Ds          , Ds          , Cvj         , Cvj         , Re          , Rr^Vhc      , Cvj         , Ds          , Cvj         , Ds          , Rr^Rhx      , Cvj         , Cvj         , Cvj         , Rr^Vhc      , Ds          , Ds          , Ww          , Wwr         , Ww          
Wo          , Ww          , Ww          , Ww          , Ww          , Ds          , Ww          , Ds          , Ds          , Ds          , Ww          , Ww          , Ww          , Ds          , Ds          , Ds          , Ww          , Ds          , Ww          , Ww          , Ww          , Wwr         , Ww          
Wo          , Wo          , Wo          , Ww          , Ww          , Ww          , Ww          , Ww          , Ww          , Ww          , Ww          , Ww          , Ww          , Ww          , Ww          , Ww          , Ww          , Ww          , Ww          , Ww          , Wo          , Ww          , Wo          
